"id","sp","site","ind","warm","photo","chill","lday","bday","risk"
"ACEPEN01_HF_01","ACEPEN","HF","ACEPEN01_HF",15,12,2,43,13,30
"ACEPEN01_HF_02","ACEPEN","HF","ACEPEN01_HF",15,8,1,52,15,37
"ACEPEN01_HF_03","ACEPEN","HF","ACEPEN01_HF",15,12,0,48,20,28
"ACEPEN01_HF_04","ACEPEN","HF","ACEPEN01_HF",20,8,2,41,24,17
"ACEPEN01_HF_05","ACEPEN","HF","ACEPEN01_HF",20,8,0,34,18,16
"ACEPEN01_HF_07","ACEPEN","HF","ACEPEN01_HF",20,12,2,27,14,13
"ACEPEN01_HF_10","ACEPEN","HF","ACEPEN01_HF",15,8,0,68,33,35
"ACEPEN01_HF_11","ACEPEN","HF","ACEPEN01_HF",20,12,1,38,13,25
"ACEPEN01_HF_12","ACEPEN","HF","ACEPEN01_HF",15,12,1,37,13,24
"ACEPEN02_HF_01","ACEPEN","HF","ACEPEN02_HF",15,8,1,44,9,35
"ACEPEN02_HF_02","ACEPEN","HF","ACEPEN02_HF",15,12,0,40,20,20
"ACEPEN02_HF_04","ACEPEN","HF","ACEPEN02_HF",15,8,0,68,21,47
"ACEPEN02_HF_06","ACEPEN","HF","ACEPEN02_HF",20,8,0,40,27,13
"ACEPEN02_HF_07","ACEPEN","HF","ACEPEN02_HF",15,12,2,37,13,24
"ACEPEN02_HF_10","ACEPEN","HF","ACEPEN02_HF",20,8,2,50,24,26
"ACEPEN02_HF_11","ACEPEN","HF","ACEPEN02_HF",20,12,1,24,8,16
"ACEPEN02_HF_12","ACEPEN","HF","ACEPEN02_HF",15,12,1,30,8,22
"ACEPEN03_HF_02","ACEPEN","HF","ACEPEN03_HF",20,12,0,33,13,20
"ACEPEN03_HF_03","ACEPEN","HF","ACEPEN03_HF",20,8,2,31,13,18
"ACEPEN03_HF_04","ACEPEN","HF","ACEPEN03_HF",15,12,0,40,20,20
"ACEPEN03_HF_05","ACEPEN","HF","ACEPEN03_HF",15,12,1,30,8,22
"ACEPEN03_HF_06","ACEPEN","HF","ACEPEN03_HF",15,8,0,68,21,47
"ACEPEN03_HF_08","ACEPEN","HF","ACEPEN03_HF",20,12,1,24,3,21
"ACEPEN03_HF_09","ACEPEN","HF","ACEPEN03_HF",20,12,2,36,20,16
"ACEPEN03_HF_10","ACEPEN","HF","ACEPEN03_HF",20,8,0,40,18,22
"ACEPEN03_HF_11","ACEPEN","HF","ACEPEN03_HF",15,12,2,50,13,37
"ACEPEN04_HF_01","ACEPEN","HF","ACEPEN04_HF",20,12,2,27,14,13
"ACEPEN04_HF_02","ACEPEN","HF","ACEPEN04_HF",15,12,0,48,20,28
"ACEPEN04_HF_03","ACEPEN","HF","ACEPEN04_HF",20,8,0,68,18,50
"ACEPEN04_HF_05","ACEPEN","HF","ACEPEN04_HF",15,12,1,37,3,34
"ACEPEN04_HF_08","ACEPEN","HF","ACEPEN04_HF",15,8,1,44,9,35
"ACEPEN04_HF_09","ACEPEN","HF","ACEPEN04_HF",20,8,2,31,13,18
"ACEPEN04_HF_10","ACEPEN","HF","ACEPEN04_HF",20,12,1,31,8,23
"ACEPEN04_HF_11","ACEPEN","HF","ACEPEN04_HF",20,12,0,29,13,16
"ACEPEN04_SH_02","ACEPEN","SH","ACEPEN04_SH",20,12,0,42,13,29
"ACEPEN04_SH_03","ACEPEN","SH","ACEPEN04_SH",15,12,2,43,13,30
"ACEPEN04_SH_05","ACEPEN","SH","ACEPEN04_SH",20,8,0,40,18,22
"ACEPEN04_SH_06","ACEPEN","SH","ACEPEN04_SH",15,12,1,37,13,24
"ACEPEN04_SH_08","ACEPEN","SH","ACEPEN04_SH",20,12,1,31,13,18
"ACEPEN04_SH_09","ACEPEN","SH","ACEPEN04_SH",20,8,2,50,24,26
"ACEPEN04_SH_11","ACEPEN","SH","ACEPEN04_SH",15,8,0,68,21,47
"ACEPEN04_SH_12","ACEPEN","SH","ACEPEN04_SH",15,12,0,54,32,22
"ACEPEN06_SH_01","ACEPEN","SH","ACEPEN06_SH",20,12,0,33,18,15
"ACEPEN06_SH_02","ACEPEN","SH","ACEPEN06_SH",20,12,2,27,20,7
"ACEPEN06_SH_03","ACEPEN","SH","ACEPEN06_SH",20,8,0,40,18,22
"ACEPEN06_SH_04","ACEPEN","SH","ACEPEN06_SH",15,8,0,82,21,61
"ACEPEN06_SH_05","ACEPEN","SH","ACEPEN06_SH",15,8,2,44,13,31
"ACEPEN06_SH_06","ACEPEN","SH","ACEPEN06_SH",15,12,1,51,8,43
"ACEPEN06_SH_07","ACEPEN","SH","ACEPEN06_SH",15,8,1,44,9,35
"ACEPEN06_SH_09","ACEPEN","SH","ACEPEN06_SH",15,12,2,30,13,17
"ACEPEN06_SH_10","ACEPEN","SH","ACEPEN06_SH",15,12,0,48,20,28
"ACEPEN07_SH_02","ACEPEN","SH","ACEPEN07_SH",20,8,2,41,24,17
"ACEPEN07_SH_05","ACEPEN","SH","ACEPEN07_SH",15,8,0,82,39,43
"ACEPEN07_SH_07","ACEPEN","SH","ACEPEN07_SH",15,12,0,61,32,29
"ACEPEN07_SH_09","ACEPEN","SH","ACEPEN07_SH",20,8,0,40,27,13
"ACEPEN07_SH_12","ACEPEN","SH","ACEPEN07_SH",20,12,0,42,26,16
"ACEPEN08_SH_01","ACEPEN","SH","ACEPEN08_SH",20,8,0,56,27,29
"ACEPEN08_SH_02","ACEPEN","SH","ACEPEN08_SH",15,12,1,57,13,44
"ACEPEN08_SH_03","ACEPEN","SH","ACEPEN08_SH",15,12,0,82,32,50
"ACEPEN08_SH_05","ACEPEN","SH","ACEPEN08_SH",15,8,1,52,15,37
"ACEPEN08_SH_06","ACEPEN","SH","ACEPEN08_SH",15,8,0,82,39,43
"ACEPEN08_SH_07","ACEPEN","SH","ACEPEN08_SH",15,12,2,50,13,37
"ACEPEN08_SH_09","ACEPEN","SH","ACEPEN08_SH",20,12,1,31,13,18
"ACEPEN08_SH_10","ACEPEN","SH","ACEPEN08_SH",20,12,2,27,14,13
"ACEPEN08_SH_11","ACEPEN","SH","ACEPEN08_SH",20,8,2,41,24,17
"ACEPEN08_SH_12","ACEPEN","SH","ACEPEN08_SH",20,12,0,39,18,21
"ACEPEN09_SH_01","ACEPEN","SH","ACEPEN09_SH",15,8,1,44,9,35
"ACEPEN09_SH_02","ACEPEN","SH","ACEPEN09_SH",15,8,2,52,13,39
"ACEPEN09_SH_04","ACEPEN","SH","ACEPEN09_SH",20,8,0,40,18,22
"ACEPEN09_SH_05","ACEPEN","SH","ACEPEN09_SH",15,12,0,48,20,28
"ACEPEN09_SH_07","ACEPEN","SH","ACEPEN09_SH",15,8,0,68,33,35
"ACEPEN09_SH_08","ACEPEN","SH","ACEPEN09_SH",20,8,2,41,13,28
"ACEPEN09_SH_10","ACEPEN","SH","ACEPEN09_SH",15,12,1,30,8,22
"ACEPEN09_SH_11","ACEPEN","SH","ACEPEN09_SH",15,12,2,37,13,24
"ACEPEN09_SH_12","ACEPEN","SH","ACEPEN09_SH",20,12,1,38,13,25
"ACEPEN11_HF_01","ACEPEN","HF","ACEPEN11_HF",20,8,2,41,24,17
"ACEPEN11_HF_02","ACEPEN","HF","ACEPEN11_HF",15,12,2,37,13,24
"ACEPEN11_HF_03","ACEPEN","HF","ACEPEN11_HF",20,12,1,31,13,18
"ACEPEN11_HF_04","ACEPEN","HF","ACEPEN11_HF",15,8,0,68,33,35
"ACEPEN11_HF_05","ACEPEN","HF","ACEPEN11_HF",20,12,2,36,14,22
"ACEPEN11_HF_06","ACEPEN","HF","ACEPEN11_HF",20,12,0,39,6,33
"ACEPEN11_HF_08","ACEPEN","HF","ACEPEN11_HF",15,8,2,44,17,27
"ACEPEN11_HF_09","ACEPEN","HF","ACEPEN11_HF",15,12,1,30,13,17
"ACEPEN11_HF_12","ACEPEN","HF","ACEPEN11_HF",15,12,0,48,32,16
"ACEPEN11_SH_01","ACEPEN","SH","ACEPEN11_SH",20,8,2,41,24,17
"ACEPEN11_SH_03","ACEPEN","SH","ACEPEN11_SH",20,12,1,31,8,23
"ACEPEN11_SH_04","ACEPEN","SH","ACEPEN11_SH",15,12,2,50,13,37
"ACEPEN11_SH_05","ACEPEN","SH","ACEPEN11_SH",15,12,0,48,20,28
"ACEPEN11_SH_08","ACEPEN","SH","ACEPEN11_SH",15,8,2,52,13,39
"ACEPEN11_SH_11","ACEPEN","SH","ACEPEN11_SH",15,8,0,68,33,35
"ACEPEN11_SH_12","ACEPEN","SH","ACEPEN11_SH",20,8,0,43,26,17
"ACEPEN12_HF_01","ACEPEN","HF","ACEPEN12_HF",20,12,0,33,26,7
"ACEPEN12_HF_02","ACEPEN","HF","ACEPEN12_HF",15,12,0,48,20,28
"ACEPEN12_HF_03","ACEPEN","HF","ACEPEN12_HF",15,12,1,43,8,35
"ACEPEN12_HF_04","ACEPEN","HF","ACEPEN12_HF",15,8,0,68,33,35
"ACEPEN12_HF_06","ACEPEN","HF","ACEPEN12_HF",20,8,0,40,18,22
"ACEPEN12_HF_08","ACEPEN","HF","ACEPEN12_HF",20,8,2,50,24,26
"ACEPEN12_HF_10","ACEPEN","HF","ACEPEN12_HF",15,8,1,52,9,43
"ACEPEN12_HF_11","ACEPEN","HF","ACEPEN12_HF",20,12,1,31,8,23
"ACERUB05_SH_01","ACERUB","SH","ACERUB05_SH",15,8,1,52,44,8
"ACERUB05_SH_02","ACERUB","SH","ACERUB05_SH",15,12,2,43,30,13
"ACERUB05_SH_03","ACERUB","SH","ACERUB05_SH",20,8,2,56,31,25
"ACERUB05_SH_04","ACERUB","SH","ACERUB05_SH",20,8,0,68,56,12
"ACERUB05_SH_05","ACERUB","SH","ACERUB05_SH",15,8,2,44,30,14
"ACERUB05_SH_07","ACERUB","SH","ACERUB05_SH",15,12,0,68,54,14
"ACERUB05_SH_08","ACERUB","SH","ACERUB05_SH",15,8,0,82,68,14
"ACERUB05_SH_11","ACERUB","SH","ACERUB05_SH",15,12,1,37,22,15
"ACERUB06_SH_02","ACERUB","SH","ACERUB06_SH",20,12,1,31,17,14
"ACERUB06_SH_03","ACERUB","SH","ACERUB06_SH",20,8,0,34,27,7
"ACERUB06_SH_07","ACERUB","SH","ACERUB06_SH",15,12,2,50,13,37
"ACERUB06_SH_11","ACERUB","SH","ACERUB06_SH",20,8,2,56,24,32
"ACERUB07_SH_01","ACERUB","SH","ACERUB07_SH",15,12,1,30,13,17
"ACERUB07_SH_02","ACERUB","SH","ACERUB07_SH",20,12,0,33,18,15
"ACERUB07_SH_03","ACERUB","SH","ACERUB07_SH",15,8,2,44,13,31
"ACERUB07_SH_04","ACERUB","SH","ACERUB07_SH",15,12,0,48,32,16
"ACERUB07_SH_06","ACERUB","SH","ACERUB07_SH",15,12,2,37,16,21
"ACERUB07_SH_07","ACERUB","SH","ACERUB07_SH",20,8,2,31,13,18
"ACERUB07_SH_08","ACERUB","SH","ACERUB07_SH",20,12,2,36,14,22
"ACERUB07_SH_09","ACERUB","SH","ACERUB07_SH",20,12,1,24,13,11
"ACERUB07_SH_10","ACERUB","SH","ACERUB07_SH",15,8,0,68,33,35
"ACERUB07_SH_12","ACERUB","SH","ACERUB07_SH",15,8,1,44,15,29
"ACERUB08_SH_02","ACERUB","SH","ACERUB08_SH",20,8,0,43,29,14
"ACERUB08_SH_03","ACERUB","SH","ACERUB08_SH",20,12,0,47,33,14
"ACERUB08_SH_04","ACERUB","SH","ACERUB08_SH",20,12,2,36,14,22
"ACERUB08_SH_05","ACERUB","SH","ACERUB08_SH",20,8,2,31,24,7
"ACERUB08_SH_06","ACERUB","SH","ACERUB08_SH",15,12,2,30,16,14
"ACERUB08_SH_07","ACERUB","SH","ACERUB08_SH",15,12,1,30,13,17
"ACERUB08_SH_09","ACERUB","SH","ACERUB08_SH",15,8,2,44,23,21
"ACERUB08_SH_11","ACERUB","SH","ACERUB08_SH",15,12,0,61,34,27
"ACERUB08_SH_12","ACERUB","SH","ACERUB08_SH",15,8,0,75,33,42
"ACERUB09_SH_02","ACERUB","SH","ACERUB09_SH",15,8,0,75,53,22
"ACERUB09_SH_05","ACERUB","SH","ACERUB09_SH",20,12,2,36,20,16
"ACERUB09_SH_06","ACERUB","SH","ACERUB09_SH",20,12,1,31,13,18
"ACERUB09_SH_07","ACERUB","SH","ACERUB09_SH",15,12,1,43,17,26
"ACERUB09_SH_08","ACERUB","SH","ACERUB09_SH",15,8,2,44,13,31
"ACERUB09_SH_09","ACERUB","SH","ACERUB09_SH",20,12,0,42,33,9
"ACERUB10_HF_01","ACERUB","HF","ACERUB10_HF",15,12,0,48,12,36
"ACERUB10_HF_02","ACERUB","HF","ACERUB10_HF",15,12,2,30,16,14
"ACERUB10_HF_04","ACERUB","HF","ACERUB10_HF",15,8,0,68,39,29
"ACERUB10_HF_05","ACERUB","HF","ACERUB10_HF",15,12,1,30,13,17
"ACERUB10_HF_06","ACERUB","HF","ACERUB10_HF",15,8,2,44,17,27
"ACERUB10_HF_07","ACERUB","HF","ACERUB10_HF",20,12,1,24,8,16
"ACERUB10_HF_08","ACERUB","HF","ACERUB10_HF",20,8,0,40,34,6
"ACERUB10_HF_09","ACERUB","HF","ACERUB10_HF",20,8,2,31,13,18
"ACERUB10_HF_10","ACERUB","HF","ACERUB10_HF",15,8,1,44,23,21
"ACERUB10_HF_11","ACERUB","HF","ACERUB10_HF",20,12,2,27,14,13
"ACERUB10_HF_12","ACERUB","HF","ACERUB10_HF",20,12,0,42,26,16
"ACERUB10_SH_02","ACERUB","SH","ACERUB10_SH",15,12,2,37,16,21
"ACERUB10_SH_03","ACERUB","SH","ACERUB10_SH",15,8,2,44,13,31
"ACERUB10_SH_04","ACERUB","SH","ACERUB10_SH",15,12,1,37,17,20
"ACERUB10_SH_06","ACERUB","SH","ACERUB10_SH",20,8,0,56,34,22
"ACERUB10_SH_07","ACERUB","SH","ACERUB10_SH",15,8,0,68,39,29
"ACERUB10_SH_08","ACERUB","SH","ACERUB10_SH",20,12,0,39,26,13
"ACERUB10_SH_09","ACERUB","SH","ACERUB10_SH",15,12,0,54,12,42
"ACERUB10_SH_10","ACERUB","SH","ACERUB10_SH",20,8,2,41,24,17
"ACERUB10_SH_11","ACERUB","SH","ACERUB10_SH",20,12,1,24,13,11
"ACERUB11_HF_02","ACERUB","HF","ACERUB11_HF",15,8,1,44,9,35
"ACERUB11_HF_04","ACERUB","HF","ACERUB11_HF",15,12,2,30,16,14
"ACERUB11_HF_05","ACERUB","HF","ACERUB11_HF",20,12,1,17,8,9
"ACERUB11_HF_06","ACERUB","HF","ACERUB11_HF",15,12,1,30,17,13
"ACERUB11_HF_08","ACERUB","HF","ACERUB11_HF",15,8,0,53,33,20
"ACERUB11_HF_09","ACERUB","HF","ACERUB11_HF",20,12,0,33,26,7
"ACERUB11_HF_11","ACERUB","HF","ACERUB11_HF",15,12,0,43,32,11
"ACERUB11_HF_12","ACERUB","HF","ACERUB11_HF",20,8,0,29,27,2
"ACERUB13_HF_01","ACERUB","HF","ACERUB13_HF",20,12,0,39,33,6
"ACERUB13_HF_02","ACERUB","HF","ACERUB13_HF",20,12,1,31,13,18
"ACERUB13_HF_03","ACERUB","HF","ACERUB13_HF",15,8,0,68,33,35
"ACERUB13_HF_06","ACERUB","HF","ACERUB13_HF",15,12,1,37,13,24
"ACERUB13_HF_07","ACERUB","HF","ACERUB13_HF",20,8,0,56,34,22
"ACERUB13_HF_08","ACERUB","HF","ACERUB13_HF",15,12,0,48,32,16
"ACERUB13_HF_10","ACERUB","HF","ACERUB13_HF",15,8,1,44,23,21
"ACERUB13_HF_11","ACERUB","HF","ACERUB13_HF",15,12,2,37,16,21
"ACERUB14_HF_01","ACERUB","HF","ACERUB14_HF",15,8,1,30,15,15
"ACERUB14_HF_03","ACERUB","HF","ACERUB14_HF",15,8,0,68,33,35
"ACERUB14_HF_04","ACERUB","HF","ACERUB14_HF",20,12,2,36,14,22
"ACERUB14_HF_05","ACERUB","HF","ACERUB14_HF",20,12,0,39,18,21
"ACERUB14_HF_06","ACERUB","HF","ACERUB14_HF",15,12,0,40,20,20
"ACERUB14_HF_07","ACERUB","HF","ACERUB14_HF",15,12,1,57,17,40
"ACERUB14_HF_08","ACERUB","HF","ACERUB14_HF",20,8,0,40,27,13
"ACERUB14_HF_09","ACERUB","HF","ACERUB14_HF",15,8,2,44,17,27
"ACERUB14_HF_10","ACERUB","HF","ACERUB14_HF",20,12,1,24,8,16
"ACERUB14_HF_11","ACERUB","HF","ACERUB14_HF",20,8,2,41,24,17
"ACERUB14_HF_12","ACERUB","HF","ACERUB14_HF",15,12,2,37,16,21
"ACERUB99_HF_01","ACERUB","HF","ACERUB99_HF",15,12,1,37,13,24
"ACERUB99_HF_04","ACERUB","HF","ACERUB99_HF",15,12,2,37,23,14
"ACERUB99_HF_05","ACERUB","HF","ACERUB99_HF",20,8,2,41,24,17
"ACERUB99_HF_06","ACERUB","HF","ACERUB99_HF",20,12,2,27,20,7
"ACERUB99_HF_08","ACERUB","HF","ACERUB99_HF",15,8,0,75,47,28
"ACERUB99_HF_09","ACERUB","HF","ACERUB99_HF",20,12,1,31,17,14
"ACERUB99_HF_10","ACERUB","HF","ACERUB99_HF",15,12,0,54,34,20
"ACERUB99_HF_12","ACERUB","HF","ACERUB99_HF",20,12,0,39,29,10
"ACESAC02_HF_03","ACESAC","HF","ACESAC02_HF",15,12,0,82,61,21
"ACESAC02_HF_07","ACESAC","HF","ACESAC02_HF",20,8,0,68,56,12
"ACESAC02_HF_11","ACESAC","HF","ACESAC02_HF",15,12,2,43,37,6
"ACESAC02_HF_12","ACESAC","HF","ACESAC02_HF",15,8,0,82,68,14
"ACESAC02_SH_08","ACESAC","SH","ACESAC02_SH",20,12,0,53,42,11
"ACESAC02_SH_11","ACESAC","SH","ACESAC02_SH",20,8,2,50,41,9
"ACESAC03_SH_01","ACESAC","SH","ACESAC03_SH",15,8,0,82,39,43
"ACESAC03_SH_08","ACESAC","SH","ACESAC03_SH",20,12,2,36,14,22
"ACESAC03_SH_09","ACESAC","SH","ACESAC03_SH",15,12,2,37,23,14
"ACESAC03_SH_12","ACESAC","SH","ACESAC03_SH",15,8,1,44,23,21
"ACESAC05_HF_04","ACESAC","HF","ACESAC05_HF",15,12,0,61,54,7
"ACESAC05_HF_07","ACESAC","HF","ACESAC05_HF",20,8,0,68,56,12
"ACESAC05_HF_11","ACESAC","HF","ACESAC05_HF",20,12,1,45,38,7
"ACESAC05_HF_12","ACESAC","HF","ACESAC05_HF",15,8,0,82,75,7
"ACESAC06_HF_03","ACESAC","HF","ACESAC06_HF",20,8,0,56,12,44
"ACESAC06_HF_08","ACESAC","HF","ACESAC06_HF",15,8,0,82,68,14
"ACESAC07_HF_02","ACESAC","HF","ACESAC07_HF",15,12,0,61,54,7
"ACESAC07_HF_11","ACESAC","HF","ACESAC07_HF",20,12,0,53,47,6
"ACESAC07_SH_01","ACESAC","SH","ACESAC07_SH",20,8,0,56,29,27
"ACESAC07_SH_03","ACESAC","SH","ACESAC07_SH",15,12,1,51,37,14
"ACESAC07_SH_07","ACESAC","SH","ACESAC07_SH",20,8,2,50,41,9
"ACESAC07_SH_08","ACESAC","SH","ACESAC07_SH",20,12,0,47,39,8
"ACESAC07_SH_10","ACESAC","SH","ACESAC07_SH",15,12,0,54,48,6
"ACESAC09_SH_01","ACESAC","SH","ACESAC09_SH",20,12,1,31,24,7
"ACESAC09_SH_02","ACESAC","SH","ACESAC09_SH",15,12,0,61,48,13
"ACESAC09_SH_03","ACESAC","SH","ACESAC09_SH",15,8,0,82,68,14
"ACESAC09_SH_04","ACESAC","SH","ACESAC09_SH",15,8,1,52,44,8
"ACESAC09_SH_05","ACESAC","SH","ACESAC09_SH",20,8,2,41,31,10
"ACESAC09_SH_06","ACESAC","SH","ACESAC09_SH",15,12,2,43,37,6
"ACESAC09_SH_07","ACESAC","SH","ACESAC09_SH",15,12,1,37,22,15
"ACESAC09_SH_09","ACESAC","SH","ACESAC09_SH",20,12,2,27,14,13
"ACESAC09_SH_12","ACESAC","SH","ACESAC09_SH",20,8,0,56,34,22
"ACESAC10_HF_02","ACESAC","HF","ACESAC10_HF",15,12,0,68,61,7
"ACESAC10_HF_03","ACESAC","HF","ACESAC10_HF",15,12,2,50,23,27
"ACESAC10_HF_05","ACESAC","HF","ACESAC10_HF",20,12,0,42,39,3
"ACESAC10_SH_01","ACESAC","SH","ACESAC10_SH",20,12,1,31,24,7
"ACESAC10_SH_05","ACESAC","SH","ACESAC10_SH",15,8,0,75,68,7
"ACESAC10_SH_08","ACESAC","SH","ACESAC10_SH",15,12,0,61,54,7
"ACESAC10_SH_09","ACESAC","SH","ACESAC10_SH",20,8,2,41,31,10
"ACESAC99_HF_04","ACESAC","HF","ACESAC99_HF",20,12,1,38,31,7
"ACESAC99_HF_05","ACESAC","HF","ACESAC99_HF",15,12,2,50,37,13
"ACESAC99_HF_06","ACESAC","HF","ACESAC99_HF",15,8,0,82,68,14
"ACESAC99_HF_09","ACESAC","HF","ACESAC99_HF",15,12,0,61,54,7
"ACESAC99_HF_10","ACESAC","HF","ACESAC99_HF",15,12,1,43,37,6
"ACESAC99_HF_12","ACESAC","HF","ACESAC99_HF",20,12,0,47,39,8
"ACESAC99_SH_01","ACESAC","SH","ACESAC99_SH",20,12,0,53,39,14
"ACESAC99_SH_03","ACESAC","SH","ACESAC99_SH",20,12,1,38,31,7
"ACESAC99_SH_05","ACESAC","SH","ACESAC99_SH",15,12,2,50,37,13
"ACESAC99_SH_06","ACESAC","SH","ACESAC99_SH",15,12,1,51,37,14
"ACESAC99_SH_08","ACESAC","SH","ACESAC99_SH",20,8,2,50,41,9
"ACESAC99_SH_09","ACESAC","SH","ACESAC99_SH",20,8,0,68,56,12
"ACESAC99_SH_10","ACESAC","SH","ACESAC99_SH",15,8,1,52,44,8
"ALNINC01_HF_01","ALNINC","HF","ALNINC01_HF",20,8,0,34,27,7
"ALNINC01_HF_02","ALNINC","HF","ALNINC01_HF",20,12,0,39,33,6
"ALNINC01_HF_03","ALNINC","HF","ALNINC01_HF",15,12,0,54,40,14
"ALNINC01_SH_02","ALNINC","SH","ALNINC01_SH",15,12,0,34,20,14
"ALNINC01_SH_03","ALNINC","SH","ALNINC01_SH",15,8,0,47,33,14
"ALNINC01_SH_04","ALNINC","SH","ALNINC01_SH",20,8,0,34,26,8
"ALNINC02_HF_01","ALNINC","HF","ALNINC02_HF",20,8,0,43,34,9
"ALNINC02_HF_02","ALNINC","HF","ALNINC02_HF",15,12,0,61,48,13
"ALNINC02_HF_03","ALNINC","HF","ALNINC02_HF",20,12,0,39,33,6
"ALNINC02_SH_01","ALNINC","SH","ALNINC02_SH",15,8,0,68,33,35
"ALNINC02_SH_02","ALNINC","SH","ALNINC02_SH",20,8,0,34,18,16
"ALNINC02_SH_04","ALNINC","SH","ALNINC02_SH",20,12,0,39,13,26
"ALNINC04_HF_03","ALNINC","HF","ALNINC04_HF",15,8,0,39,33,6
"ALNINC04_HF_04","ALNINC","HF","ALNINC04_HF",15,12,0,34,29,5
"ALNINC04_SH_01","ALNINC","SH","ALNINC04_SH",15,12,0,61,40,21
"ALNINC04_SH_02","ALNINC","SH","ALNINC04_SH",20,12,0,33,29,4
"ALNINC04_SH_03","ALNINC","SH","ALNINC04_SH",15,8,0,68,39,29
"ALNINC05_HF_01","ALNINC","HF","ALNINC05_HF",15,12,0,54,34,20
"ALNINC05_HF_02","ALNINC","HF","ALNINC05_HF",20,8,0,56,34,22
"ALNINC05_HF_03","ALNINC","HF","ALNINC05_HF",20,12,0,47,13,34
"ALNINC05_HF_04","ALNINC","HF","ALNINC05_HF",15,8,0,75,13,62
"ALNINC05_SH_01","ALNINC","SH","ALNINC05_SH",15,8,0,68,42,26
"ALNINC05_SH_02","ALNINC","SH","ALNINC05_SH",20,8,0,34,27,7
"ALNINC05_SH_03","ALNINC","SH","ALNINC05_SH",20,12,0,47,33,14
"ALNINC05_SH_04","ALNINC","SH","ALNINC05_SH",15,12,0,40,12,28
"ALNINC06_SH_01","ALNINC","SH","ALNINC06_SH",15,12,0,40,20,20
"ALNINC06_SH_02","ALNINC","SH","ALNINC06_SH",15,8,0,68,13,55
"ALNINC06_SH_03","ALNINC","SH","ALNINC06_SH",20,12,0,33,13,20
"ALNINC06_SH_04","ALNINC","SH","ALNINC06_SH",20,8,0,56,29,27
"ALNINC07_SH_01","ALNINC","SH","ALNINC07_SH",20,12,0,39,18,21
"ALNINC07_SH_02","ALNINC","SH","ALNINC07_SH",15,12,0,40,34,6
"ALNINC07_SH_03","ALNINC","SH","ALNINC07_SH",15,8,0,53,33,20
"ALNINC07_SH_04","ALNINC","SH","ALNINC07_SH",20,8,0,34,27,7
"ALNINC08_HF_01","ALNINC","HF","ALNINC08_HF",20,8,0,43,34,9
"ALNINC08_HF_02","ALNINC","HF","ALNINC08_HF",20,12,0,42,13,29
"ALNINC08_HF_03","ALNINC","HF","ALNINC08_HF",15,12,0,61,29,32
"ALNINC08_HF_04","ALNINC","HF","ALNINC08_HF",15,8,0,68,47,21
"AROMEL04_HF_01","AROMEL","HF","AROMEL04_HF",20,8,0,26,13,13
"AROMEL04_HF_02","AROMEL","HF","AROMEL04_HF",15,8,0,42,13,29
"AROMEL04_HF_03","AROMEL","HF","AROMEL04_HF",15,12,0,32,12,20
"AROMEL04_HF_04","AROMEL","HF","AROMEL04_HF",20,12,0,18,13,5
"AROMEL08_HF_01","AROMEL","HF","AROMEL08_HF",20,8,0,27,12,15
"AROMEL08_HF_02","AROMEL","HF","AROMEL08_HF",15,8,0,39,13,26
"AROMEL08_HF_03","AROMEL","HF","AROMEL08_HF",20,12,0,26,13,13
"AROMEL08_HF_04","AROMEL","HF","AROMEL08_HF",15,12,0,29,12,17
"AROMEL11_HF_01","AROMEL","HF","AROMEL11_HF",15,8,0,42,21,21
"AROMEL11_HF_02","AROMEL","HF","AROMEL11_HF",15,12,0,32,12,20
"AROMEL11_HF_03","AROMEL","HF","AROMEL11_HF",20,8,0,27,12,15
"AROMEL11_HF_04","AROMEL","HF","AROMEL11_HF",20,12,0,18,13,5
"BETALL01_SH_02","BETALL","SH","BETALL01_SH",15,12,1,17,13,4
"BETALL01_SH_03","BETALL","SH","BETALL01_SH",20,8,2,50,24,26
"BETALL01_SH_04","BETALL","SH","BETALL01_SH",20,12,1,38,13,25
"BETALL01_SH_05","BETALL","SH","BETALL01_SH",15,8,0,68,39,29
"BETALL01_SH_09","BETALL","SH","BETALL01_SH",15,8,1,30,9,21
"BETALL01_SH_10","BETALL","SH","BETALL01_SH",20,8,0,56,34,22
"BETALL01_SH_11","BETALL","SH","BETALL01_SH",20,12,2,27,14,13
"BETALL02_SH_01","BETALL","SH","BETALL02_SH",20,12,0,39,26,13
"BETALL02_SH_02","BETALL","SH","BETALL02_SH",15,8,2,52,23,29
"BETALL02_SH_04","BETALL","SH","BETALL02_SH",20,12,1,17,13,4
"BETALL02_SH_05","BETALL","SH","BETALL02_SH",15,12,0,48,32,16
"BETALL02_SH_06","BETALL","SH","BETALL02_SH",20,8,0,56,34,22
"BETALL02_SH_07","BETALL","SH","BETALL02_SH",15,12,1,30,17,13
"BETALL02_SH_08","BETALL","SH","BETALL02_SH",15,8,1,52,23,29
"BETALL02_SH_09","BETALL","SH","BETALL02_SH",15,8,0,68,47,21
"BETALL02_SH_11","BETALL","SH","BETALL02_SH",15,12,2,43,16,27
"BETALL02_SH_12","BETALL","SH","BETALL02_SH",20,8,2,31,24,7
"BETALL03_SH_03","BETALL","SH","BETALL03_SH",20,12,1,17,13,4
"BETALL03_SH_04","BETALL","SH","BETALL03_SH",15,8,1,44,15,29
"BETALL03_SH_06","BETALL","SH","BETALL03_SH",20,8,2,31,24,7
"BETALL03_SH_07","BETALL","SH","BETALL03_SH",15,12,0,40,32,8
"BETALL03_SH_08","BETALL","SH","BETALL03_SH",20,12,2,36,14,22
"BETALL03_SH_09","BETALL","SH","BETALL03_SH",15,12,1,30,13,17
"BETALL03_SH_10","BETALL","SH","BETALL03_SH",15,8,2,30,13,17
"BETALL03_SH_11","BETALL","SH","BETALL03_SH",15,12,2,37,16,21
"BETALL03_SH_12","BETALL","SH","BETALL03_SH",15,8,0,47,33,14
"BETALL08_SH_01","BETALL","SH","BETALL08_SH",15,12,2,30,13,17
"BETALL08_SH_02","BETALL","SH","BETALL08_SH",15,8,1,30,9,21
"BETALL08_SH_03","BETALL","SH","BETALL08_SH",15,8,0,42,33,9
"BETALL08_SH_04","BETALL","SH","BETALL08_SH",20,12,1,24,8,16
"BETALL08_SH_05","BETALL","SH","BETALL08_SH",20,12,0,26,18,8
"BETALL08_SH_06","BETALL","SH","BETALL08_SH",20,8,2,24,13,11
"BETALL08_SH_07","BETALL","SH","BETALL08_SH",15,12,1,17,13,4
"BETALL08_SH_08","BETALL","SH","BETALL08_SH",15,12,0,40,32,8
"BETALL08_SH_09","BETALL","SH","BETALL08_SH",15,8,2,44,13,31
"BETALL08_SH_10","BETALL","SH","BETALL08_SH",20,8,0,34,27,7
"BETALL09_SH_01","BETALL","SH","BETALL09_SH",15,8,2,44,17,27
"BETALL09_SH_02","BETALL","SH","BETALL09_SH",20,8,0,40,34,6
"BETALL09_SH_03","BETALL","SH","BETALL09_SH",20,12,2,27,14,13
"BETALL09_SH_04","BETALL","SH","BETALL09_SH",15,8,1,30,15,15
"BETALL09_SH_05","BETALL","SH","BETALL09_SH",15,12,1,22,13,9
"BETALL09_SH_06","BETALL","SH","BETALL09_SH",20,12,0,39,29,10
"BETALL09_SH_07","BETALL","SH","BETALL09_SH",15,12,2,37,13,24
"BETALL09_SH_08","BETALL","SH","BETALL09_SH",15,8,0,68,42,26
"BETALL09_SH_09","BETALL","SH","BETALL09_SH",20,8,2,31,24,7
"BETALL09_SH_11","BETALL","SH","BETALL09_SH",15,12,0,48,32,16
"BETALL09_SH_12","BETALL","SH","BETALL09_SH",20,12,1,24,8,16
"BETALL10_HF_02","BETALL","HF","BETALL10_HF",20,8,2,31,24,7
"BETALL10_HF_03","BETALL","HF","BETALL10_HF",15,8,0,68,33,35
"BETALL10_HF_04","BETALL","HF","BETALL10_HF",20,12,0,26,18,8
"BETALL10_HF_05","BETALL","HF","BETALL10_HF",20,12,2,36,14,22
"BETALL10_HF_06","BETALL","HF","BETALL10_HF",15,12,1,30,13,17
"BETALL10_HF_08","BETALL","HF","BETALL10_HF",20,12,1,38,13,25
"BETALL10_HF_09","BETALL","HF","BETALL10_HF",15,8,2,30,17,13
"BETALL10_HF_10","BETALL","HF","BETALL10_HF",20,8,0,34,26,8
"BETALL10_HF_11","BETALL","HF","BETALL10_HF",15,12,0,40,32,8
"BETALL10_HF_12","BETALL","HF","BETALL10_HF",15,12,2,37,23,14
"BETALL10_SH_01","BETALL","SH","BETALL10_SH",20,8,2,24,13,11
"BETALL10_SH_02","BETALL","SH","BETALL10_SH",20,12,0,29,26,3
"BETALL10_SH_03","BETALL","SH","BETALL10_SH",15,12,1,22,13,9
"BETALL10_SH_04","BETALL","SH","BETALL10_SH",20,8,0,34,26,8
"BETALL10_SH_05","BETALL","SH","BETALL10_SH",15,8,0,47,33,14
"BETALL10_SH_07","BETALL","SH","BETALL10_SH",15,8,2,30,13,17
"BETALL10_SH_08","BETALL","SH","BETALL10_SH",15,8,1,44,15,29
"BETALL10_SH_09","BETALL","SH","BETALL10_SH",20,12,2,27,14,13
"BETALL10_SH_10","BETALL","SH","BETALL10_SH",20,12,1,17,8,9
"BETALL10_SH_11","BETALL","SH","BETALL10_SH",15,12,0,40,32,8
"BETALL10_SH_12","BETALL","SH","BETALL10_SH",15,12,2,23,13,10
"BETALL16_HF_01","BETALL","HF","BETALL16_HF",15,8,2,30,17,13
"BETALL16_HF_02","BETALL","HF","BETALL16_HF",15,12,0,29,20,9
"BETALL16_HF_03","BETALL","HF","BETALL16_HF",20,12,2,27,14,13
"BETALL16_HF_04","BETALL","HF","BETALL16_HF",20,8,2,24,13,11
"BETALL16_HF_05","BETALL","HF","BETALL16_HF",15,8,0,53,33,20
"BETALL16_HF_06","BETALL","HF","BETALL16_HF",20,12,0,26,18,8
"BETALL16_HF_07","BETALL","HF","BETALL16_HF",20,8,0,34,26,8
"BETALL16_HF_08","BETALL","HF","BETALL16_HF",15,12,1,22,13,9
"BETALL16_HF_09","BETALL","HF","BETALL16_HF",15,8,1,30,15,15
"BETALL16_HF_10","BETALL","HF","BETALL16_HF",20,12,1,24,13,11
"BETALL16_HF_11","BETALL","HF","BETALL16_HF",15,12,2,30,13,17
"BETALL17_HF_01","BETALL","HF","BETALL17_HF",20,8,2,31,24,7
"BETALL17_HF_02","BETALL","HF","BETALL17_HF",20,12,1,24,13,11
"BETALL17_HF_04","BETALL","HF","BETALL17_HF",15,12,1,30,17,13
"BETALL17_HF_05","BETALL","HF","BETALL17_HF",15,12,2,30,23,7
"BETALL17_HF_08","BETALL","HF","BETALL17_HF",15,8,2,44,23,21
"BETALL17_HF_10","BETALL","HF","BETALL17_HF",20,8,0,34,27,7
"BETALL17_HF_11","BETALL","HF","BETALL17_HF",15,8,0,68,39,29
"BETALL17_HF_12","BETALL","HF","BETALL17_HF",15,8,1,44,23,21
"BETALL18_HF_01","BETALL","HF","BETALL18_HF",15,8,0,39,21,18
"BETALL18_HF_04","BETALL","HF","BETALL18_HF",20,12,0,26,18,8
"BETALL18_HF_05","BETALL","HF","BETALL18_HF",20,12,1,38,8,30
"BETALL18_HF_07","BETALL","HF","BETALL18_HF",15,12,0,32,20,12
"BETALL18_HF_09","BETALL","HF","BETALL18_HF",20,8,2,41,24,17
"BETALL18_HF_11","BETALL","HF","BETALL18_HF",15,8,1,30,15,15
"BETALL18_HF_12","BETALL","HF","BETALL18_HF",15,12,1,37,13,24
"BETALL19_HF_01","BETALL","HF","BETALL19_HF",15,12,0,29,20,9
"BETALL19_HF_02","BETALL","HF","BETALL19_HF",15,8,1,44,15,29
"BETALL19_HF_03","BETALL","HF","BETALL19_HF",20,12,1,31,8,23
"BETALL19_HF_04","BETALL","HF","BETALL19_HF",20,12,2,27,14,13
"BETALL19_HF_05","BETALL","HF","BETALL19_HF",15,12,1,37,13,24
"BETALL19_HF_06","BETALL","HF","BETALL19_HF",20,8,0,27,18,9
"BETALL19_HF_07","BETALL","HF","BETALL19_HF",20,8,2,31,13,18
"BETALL19_HF_09","BETALL","HF","BETALL19_HF",20,12,0,26,18,8
"BETALL19_HF_10","BETALL","HF","BETALL19_HF",15,12,2,30,13,17
"BETALL19_HF_11","BETALL","HF","BETALL19_HF",15,8,2,30,13,17
"BETALL19_HF_12","BETALL","HF","BETALL19_HF",15,8,0,42,33,9
"BETALL20_HF_01","BETALL","HF","BETALL20_HF",20,12,1,17,13,4
"BETALL20_HF_02","BETALL","HF","BETALL20_HF",15,12,1,30,13,17
"BETALL20_HF_04","BETALL","HF","BETALL20_HF",20,12,2,27,14,13
"BETALL20_HF_05","BETALL","HF","BETALL20_HF",15,8,0,68,33,35
"BETALL20_HF_06","BETALL","HF","BETALL20_HF",15,12,2,30,13,17
"BETALL20_HF_07","BETALL","HF","BETALL20_HF",15,8,2,30,17,13
"BETALL20_HF_09","BETALL","HF","BETALL20_HF",15,12,0,40,29,11
"BETALL20_HF_10","BETALL","HF","BETALL20_HF",20,8,0,34,26,8
"BETALL20_HF_11","BETALL","HF","BETALL20_HF",20,8,2,31,24,7
"BETALL20_HF_12","BETALL","HF","BETALL20_HF",15,8,1,44,15,29
"BETLEN04_HF_01","BETLEN","HF","BETLEN04_HF",15,12,0,61,32,29
"BETLEN04_HF_02","BETLEN","HF","BETLEN04_HF",15,8,0,68,39,29
"BETLEN04_HF_04","BETLEN","HF","BETLEN04_HF",20,8,0,56,29,27
"BETLEN05_HF_01","BETLEN","HF","BETLEN05_HF",15,12,0,43,32,11
"BETLEN05_HF_02","BETLEN","HF","BETLEN05_HF",15,8,0,75,21,54
"BETLEN05_HF_03","BETLEN","HF","BETLEN05_HF",20,8,0,40,34,6
"BETLEN05_HF_04","BETLEN","HF","BETLEN05_HF",20,12,0,33,26,7
"BETLEN06_HF_01","BETLEN","HF","BETLEN06_HF",20,12,0,39,26,13
"BETLEN06_HF_02","BETLEN","HF","BETLEN06_HF",20,8,0,40,27,13
"BETLEN06_HF_03","BETLEN","HF","BETLEN06_HF",15,12,0,43,32,11
"BETLEN06_HF_04","BETLEN","HF","BETLEN06_HF",15,8,0,68,47,21
"BETLEN08_HF_01","BETLEN","HF","BETLEN08_HF",20,8,0,43,27,16
"BETLEN08_HF_02","BETLEN","HF","BETLEN08_HF",15,12,0,40,20,20
"BETLEN08_HF_03","BETLEN","HF","BETLEN08_HF",20,12,0,33,26,7
"BETLEN08_HF_04","BETLEN","HF","BETLEN08_HF",15,8,0,68,33,35
"BETLEN10_HF_01","BETLEN","HF","BETLEN10_HF",20,12,0,39,29,10
"BETLEN10_HF_02","BETLEN","HF","BETLEN10_HF",15,8,0,68,33,35
"BETLEN10_HF_03","BETLEN","HF","BETLEN10_HF",20,8,0,43,27,16
"BETLEN10_HF_04","BETLEN","HF","BETLEN10_HF",15,12,0,68,32,36
"BETLEN11_HF_01","BETLEN","HF","BETLEN11_HF",20,12,0,39,26,13
"BETLEN11_HF_02","BETLEN","HF","BETLEN11_HF",20,8,0,40,27,13
"BETLEN11_HF_03","BETLEN","HF","BETLEN11_HF",15,8,0,68,33,35
"BETLEN11_HF_04","BETLEN","HF","BETLEN11_HF",15,12,0,48,29,19
"BETPAP04_SH_01","BETPAP","SH","BETPAP04_SH",15,8,0,68,21,47
"BETPAP04_SH_02","BETPAP","SH","BETPAP04_SH",15,12,1,30,13,17
"BETPAP04_SH_03","BETPAP","SH","BETPAP04_SH",15,12,0,34,32,2
"BETPAP04_SH_04","BETPAP","SH","BETPAP04_SH",20,12,1,17,13,4
"BETPAP04_SH_05","BETPAP","SH","BETPAP04_SH",20,12,2,27,14,13
"BETPAP04_SH_06","BETPAP","SH","BETPAP04_SH",15,8,1,44,9,35
"BETPAP04_SH_07","BETPAP","SH","BETPAP04_SH",15,8,2,30,17,13
"BETPAP04_SH_08","BETPAP","SH","BETPAP04_SH",15,12,2,37,23,14
"BETPAP04_SH_09","BETPAP","SH","BETPAP04_SH",20,8,2,31,13,18
"BETPAP04_SH_10","BETPAP","SH","BETPAP04_SH",20,8,0,34,18,16
"BETPAP04_SH_12","BETPAP","SH","BETPAP04_SH",20,12,0,26,18,8
"BETPAP06_HF_01","BETPAP","HF","BETPAP06_HF",15,8,1,23,15,8
"BETPAP06_HF_02","BETPAP","HF","BETPAP06_HF",15,8,2,30,17,13
"BETPAP06_HF_03","BETPAP","HF","BETPAP06_HF",15,12,0,29,20,9
"BETPAP06_HF_04","BETPAP","HF","BETPAP06_HF",20,12,1,13,8,5
"BETPAP06_HF_05","BETPAP","HF","BETPAP06_HF",15,12,1,13,8,5
"BETPAP06_HF_07","BETPAP","HF","BETPAP06_HF",15,8,0,33,21,12
"BETPAP06_HF_08","BETPAP","HF","BETPAP06_HF",15,12,2,23,13,10
"BETPAP06_HF_09","BETPAP","HF","BETPAP06_HF",20,8,0,27,18,9
"BETPAP06_HF_10","BETPAP","HF","BETPAP06_HF",20,8,2,24,13,11
"BETPAP06_HF_11","BETPAP","HF","BETPAP06_HF",20,12,0,26,13,13
"BETPAP06_HF_12","BETPAP","HF","BETPAP06_HF",20,12,2,36,14,22
"BETPAP06_SH_03","BETPAP","SH","BETPAP06_SH",20,12,0,26,13,13
"BETPAP06_SH_04","BETPAP","SH","BETPAP06_SH",15,8,0,53,21,32
"BETPAP06_SH_06","BETPAP","SH","BETPAP06_SH",15,12,0,68,29,39
"BETPAP06_SH_07","BETPAP","SH","BETPAP06_SH",15,12,2,30,13,17
"BETPAP06_SH_08","BETPAP","SH","BETPAP06_SH",15,8,2,30,17,13
"BETPAP06_SH_09","BETPAP","SH","BETPAP06_SH",15,8,1,30,15,15
"BETPAP06_SH_10","BETPAP","SH","BETPAP06_SH",15,12,1,30,13,17
"BETPAP06_SH_11","BETPAP","SH","BETPAP06_SH",20,12,1,38,13,25
"BETPAP07_HF_02","BETPAP","HF","BETPAP07_HF",20,8,0,34,18,16
"BETPAP07_HF_03","BETPAP","HF","BETPAP07_HF",15,8,0,33,21,12
"BETPAP07_HF_04","BETPAP","HF","BETPAP07_HF",15,12,1,13,8,5
"BETPAP07_HF_05","BETPAP","HF","BETPAP07_HF",15,12,2,30,13,17
"BETPAP07_HF_07","BETPAP","HF","BETPAP07_HF",15,8,2,17,13,4
"BETPAP07_HF_08","BETPAP","HF","BETPAP07_HF",20,12,0,29,13,16
"BETPAP07_HF_09","BETPAP","HF","BETPAP07_HF",15,8,1,15,9,6
"BETPAP07_HF_10","BETPAP","HF","BETPAP07_HF",20,8,2,24,13,11
"BETPAP07_HF_11","BETPAP","HF","BETPAP07_HF",15,12,0,32,20,12
"BETPAP07_SH_01","BETPAP","SH","BETPAP07_SH",15,12,1,43,22,21
"BETPAP07_SH_02","BETPAP","SH","BETPAP07_SH",15,8,2,44,13,31
"BETPAP07_SH_03","BETPAP","SH","BETPAP07_SH",20,12,0,26,18,8
"BETPAP07_SH_04","BETPAP","SH","BETPAP07_SH",15,8,1,52,15,37
"BETPAP07_SH_05","BETPAP","SH","BETPAP07_SH",20,12,1,31,13,18
"BETPAP07_SH_06","BETPAP","SH","BETPAP07_SH",15,8,0,42,33,9
"BETPAP07_SH_08","BETPAP","SH","BETPAP07_SH",15,12,2,43,16,27
"BETPAP07_SH_10","BETPAP","SH","BETPAP07_SH",20,8,2,31,13,18
"BETPAP07_SH_11","BETPAP","SH","BETPAP07_SH",20,8,0,34,27,7
"BETPAP07_SH_12","BETPAP","SH","BETPAP07_SH",15,12,0,40,32,8
"BETPAP08_SH_01","BETPAP","SH","BETPAP08_SH",15,8,0,68,33,35
"BETPAP08_SH_02","BETPAP","SH","BETPAP08_SH",15,8,1,44,15,29
"BETPAP08_SH_03","BETPAP","SH","BETPAP08_SH",20,8,0,56,27,29
"BETPAP08_SH_04","BETPAP","SH","BETPAP08_SH",20,8,2,31,13,18
"BETPAP08_SH_07","BETPAP","SH","BETPAP08_SH",15,12,0,48,34,14
"BETPAP08_SH_09","BETPAP","SH","BETPAP08_SH",15,12,1,22,17,5
"BETPAP08_SH_10","BETPAP","SH","BETPAP08_SH",15,8,2,52,23,29
"BETPAP08_SH_11","BETPAP","SH","BETPAP08_SH",15,12,2,37,23,14
"BETPAP08_SH_12","BETPAP","SH","BETPAP08_SH",20,12,1,31,13,18
"BETPAP09_HF_02","BETPAP","HF","BETPAP09_HF",15,8,0,39,21,18
"BETPAP09_HF_03","BETPAP","HF","BETPAP09_HF",15,12,2,37,13,24
"BETPAP09_HF_04","BETPAP","HF","BETPAP09_HF",20,8,2,24,13,11
"BETPAP09_HF_05","BETPAP","HF","BETPAP09_HF",20,12,2,36,14,22
"BETPAP09_HF_06","BETPAP","HF","BETPAP09_HF",15,8,1,23,9,14
"BETPAP09_HF_08","BETPAP","HF","BETPAP09_HF",20,12,1,13,8,5
"BETPAP09_HF_09","BETPAP","HF","BETPAP09_HF",15,8,2,30,13,17
"BETPAP09_HF_10","BETPAP","HF","BETPAP09_HF",20,12,0,26,13,13
"BETPAP09_HF_11","BETPAP","HF","BETPAP09_HF",20,8,0,27,18,9
"BETPAP09_HF_12","BETPAP","HF","BETPAP09_HF",15,12,0,32,20,12
"BETPAP09_SH_01","BETPAP","SH","BETPAP09_SH",15,12,2,30,16,14
"BETPAP09_SH_02","BETPAP","SH","BETPAP09_SH",20,12,0,26,18,8
"BETPAP09_SH_03","BETPAP","SH","BETPAP09_SH",15,12,0,34,20,14
"BETPAP09_SH_04","BETPAP","SH","BETPAP09_SH",15,8,2,44,13,31
"BETPAP09_SH_05","BETPAP","SH","BETPAP09_SH",15,8,1,44,15,29
"BETPAP09_SH_06","BETPAP","SH","BETPAP09_SH",15,12,1,22,13,9
"BETPAP09_SH_07","BETPAP","SH","BETPAP09_SH",20,12,2,27,14,13
"BETPAP09_SH_08","BETPAP","SH","BETPAP09_SH",20,8,0,34,18,16
"BETPAP09_SH_09","BETPAP","SH","BETPAP09_SH",20,12,1,17,13,4
"BETPAP09_SH_10","BETPAP","SH","BETPAP09_SH",15,8,0,68,33,35
"BETPAP09_SH_11","BETPAP","SH","BETPAP09_SH",20,8,2,24,13,11
"BETPAP10_SH_02","BETPAP","SH","BETPAP10_SH",15,12,0,40,20,20
"BETPAP10_SH_03","BETPAP","SH","BETPAP10_SH",15,8,0,53,21,32
"BETPAP10_SH_04","BETPAP","SH","BETPAP10_SH",15,12,2,30,16,14
"BETPAP10_SH_06","BETPAP","SH","BETPAP10_SH",15,8,2,44,13,31
"BETPAP10_SH_07","BETPAP","SH","BETPAP10_SH",20,12,2,20,14,6
"BETPAP10_SH_08","BETPAP","SH","BETPAP10_SH",20,12,0,26,13,13
"BETPAP10_SH_09","BETPAP","SH","BETPAP10_SH",15,8,1,30,15,15
"BETPAP10_SH_10","BETPAP","SH","BETPAP10_SH",20,8,2,24,13,11
"BETPAP10_SH_12","BETPAP","SH","BETPAP10_SH",15,12,1,30,13,17
"BETPAP13_HF_01","BETPAP","HF","BETPAP13_HF",20,8,0,26,18,8
"BETPAP13_HF_02","BETPAP","HF","BETPAP13_HF",15,8,1,44,15,29
"BETPAP13_HF_03","BETPAP","HF","BETPAP13_HF",15,8,0,47,21,26
"BETPAP13_HF_04","BETPAP","HF","BETPAP13_HF",15,8,2,44,23,21
"BETPAP13_HF_05","BETPAP","HF","BETPAP13_HF",20,12,1,24,13,11
"BETPAP13_HF_06","BETPAP","HF","BETPAP13_HF",15,12,0,61,20,41
"BETPAP13_HF_07","BETPAP","HF","BETPAP13_HF",15,12,2,23,16,7
"BETPAP13_HF_09","BETPAP","HF","BETPAP13_HF",20,12,2,27,14,13
"BETPAP13_HF_10","BETPAP","HF","BETPAP13_HF",20,12,0,33,26,7
"BETPAP13_HF_12","BETPAP","HF","BETPAP13_HF",15,12,1,30,13,17
"BETPAP14_HF_01","BETPAP","HF","BETPAP14_HF",15,12,1,22,13,9
"BETPAP14_HF_02","BETPAP","HF","BETPAP14_HF",20,12,0,26,18,8
"BETPAP14_HF_03","BETPAP","HF","BETPAP14_HF",20,8,0,27,18,9
"BETPAP14_HF_05","BETPAP","HF","BETPAP14_HF",15,8,1,52,15,37
"BETPAP14_HF_07","BETPAP","HF","BETPAP14_HF",15,8,0,39,21,18
"BETPAP14_HF_09","BETPAP","HF","BETPAP14_HF",15,12,0,32,20,12
"BETPAP14_HF_11","BETPAP","HF","BETPAP14_HF",20,12,1,24,13,11
"BETPAP14_HF_12","BETPAP","HF","BETPAP14_HF",15,12,2,30,16,14
"BETPAP15_HF_01","BETPAP","HF","BETPAP15_HF",15,8,2,30,13,17
"BETPAP15_HF_03","BETPAP","HF","BETPAP15_HF",20,8,0,29,27,2
"BETPAP15_HF_04","BETPAP","HF","BETPAP15_HF",20,12,0,29,26,3
"BETPAP15_HF_06","BETPAP","HF","BETPAP15_HF",15,8,1,52,23,29
"BETPAP15_HF_07","BETPAP","HF","BETPAP15_HF",15,8,0,47,33,14
"BETPAP15_HF_09","BETPAP","HF","BETPAP15_HF",20,8,2,31,13,18
"BETPAP15_HF_11","BETPAP","HF","BETPAP15_HF",15,12,2,23,13,10
"BETPAP15_HF_12","BETPAP","HF","BETPAP15_HF",15,12,1,30,13,17
"CORCOR01_HF_02","CORCOR","HF","CORCOR01_HF",20,8,0,34,27,7
"CORCOR01_HF_04","CORCOR","HF","CORCOR01_HF",15,8,0,68,33,35
"CORCOR05_SH_01","CORCOR","SH","CORCOR05_SH",15,8,0,39,13,26
"CORCOR05_SH_02","CORCOR","SH","CORCOR05_SH",15,12,0,29,20,9
"CORCOR05_SH_04","CORCOR","SH","CORCOR05_SH",20,8,0,27,18,9
"CORCOR06_HF_01","CORCOR","HF","CORCOR06_HF",15,8,0,39,33,6
"CORCOR06_HF_02","CORCOR","HF","CORCOR06_HF",20,12,0,18,13,5
"CORCOR06_HF_03","CORCOR","HF","CORCOR06_HF",15,12,0,29,20,9
"CORCOR06_HF_04","CORCOR","HF","CORCOR06_HF",20,8,0,27,18,9
"CORCOR07_HF_01","CORCOR","HF","CORCOR07_HF",20,12,0,26,18,8
"CORCOR07_HF_02","CORCOR","HF","CORCOR07_HF",15,12,0,29,20,9
"CORCOR07_HF_03","CORCOR","HF","CORCOR07_HF",20,8,0,29,27,2
"CORCOR07_HF_04","CORCOR","HF","CORCOR07_HF",15,8,0,42,33,9
"CORCOR07_SH_01","CORCOR","SH","CORCOR07_SH",15,8,0,68,13,55
"CORCOR07_SH_03","CORCOR","SH","CORCOR07_SH",15,12,0,29,20,9
"CORCOR07_SH_04","CORCOR","SH","CORCOR07_SH",20,8,0,34,27,7
"CORCOR08_HF_02","CORCOR","HF","CORCOR08_HF",15,12,0,34,20,14
"CORCOR08_HF_03","CORCOR","HF","CORCOR08_HF",15,8,0,47,33,14
"CORCOR08_HF_04","CORCOR","HF","CORCOR08_HF",20,8,0,34,27,7
"CORCOR08_SH_01","CORCOR","SH","CORCOR08_SH",20,12,0,26,18,8
"CORCOR08_SH_02","CORCOR","SH","CORCOR08_SH",15,8,0,39,13,26
"CORCOR08_SH_03","CORCOR","SH","CORCOR08_SH",15,12,0,32,20,12
"CORCOR08_SH_04","CORCOR","SH","CORCOR08_SH",20,8,0,27,12,15
"CORCOR09_HF_01","CORCOR","HF","CORCOR09_HF",20,8,0,27,18,9
"CORCOR09_HF_03","CORCOR","HF","CORCOR09_HF",15,12,0,34,32,2
"CORCOR09_HF_04","CORCOR","HF","CORCOR09_HF",15,8,0,53,33,20
"CORCOR09_SH_01","CORCOR","SH","CORCOR09_SH",20,8,0,26,18,8
"CORCOR09_SH_02","CORCOR","SH","CORCOR09_SH",15,8,0,33,21,12
"CORCOR09_SH_03","CORCOR","SH","CORCOR09_SH",15,12,0,34,32,2
"CORCOR10_HF_01","CORCOR","HF","CORCOR10_HF",20,8,0,34,27,7
"CORCOR10_HF_02","CORCOR","HF","CORCOR10_HF",15,12,0,40,29,11
"CORCOR10_HF_03","CORCOR","HF","CORCOR10_HF",20,12,0,29,26,3
"CORCOR10_SH_01","CORCOR","SH","CORCOR10_SH",20,12,0,26,18,8
"CORCOR10_SH_02","CORCOR","SH","CORCOR10_SH",15,8,0,39,33,6
"CORCOR10_SH_03","CORCOR","SH","CORCOR10_SH",15,12,0,29,20,9
"CORCOR10_SH_04","CORCOR","SH","CORCOR10_SH",20,8,0,29,26,3
"CORCOR11_SH_01","CORCOR","SH","CORCOR11_SH",15,12,0,32,20,12
"CORCOR11_SH_02","CORCOR","SH","CORCOR11_SH",15,8,0,53,33,20
"CORCOR11_SH_03","CORCOR","SH","CORCOR11_SH",20,12,0,26,18,8
"CORCOR11_SH_04","CORCOR","SH","CORCOR11_SH",20,8,0,34,26,8
"FAGGRA02_SH_01","FAGGRA","SH","FAGGRA02_SH",20,12,0,47,42,5
"FAGGRA02_SH_03","FAGGRA","SH","FAGGRA02_SH",15,12,0,54,43,11
"FAGGRA02_SH_07","FAGGRA","SH","FAGGRA02_SH",20,12,1,31,24,7
"FAGGRA02_SH_11","FAGGRA","SH","FAGGRA02_SH",15,12,2,43,30,13
"FAGGRA02_SH_12","FAGGRA","SH","FAGGRA02_SH",20,12,2,36,27,9
"FAGGRA03_HF_01","FAGGRA","HF","FAGGRA03_HF",20,12,1,45,38,7
"FAGGRA03_HF_07","FAGGRA","HF","FAGGRA03_HF",15,12,1,51,43,8
"FAGGRA04_SH_05","FAGGRA","SH","FAGGRA04_SH",15,12,0,61,43,18
"FAGGRA04_SH_08","FAGGRA","SH","FAGGRA04_SH",15,12,2,50,30,20
"FAGGRA04_SH_10","FAGGRA","SH","FAGGRA04_SH",15,12,1,43,37,6
"FAGGRA05_SH_01","FAGGRA","SH","FAGGRA05_SH",15,12,0,61,48,13
"FAGGRA06_SH_03","FAGGRA","SH","FAGGRA06_SH",20,12,2,36,27,9
"FAGGRA06_SH_04","FAGGRA","SH","FAGGRA06_SH",15,12,0,61,54,7
"FAGGRA06_SH_05","FAGGRA","SH","FAGGRA06_SH",20,12,0,53,39,14
"FAGGRA06_SH_09","FAGGRA","SH","FAGGRA06_SH",15,12,1,43,37,6
"FAGGRA06_SH_11","FAGGRA","SH","FAGGRA06_SH",15,12,2,43,37,6
"FAGGRA07_SH_01","FAGGRA","SH","FAGGRA07_SH",15,12,2,43,30,13
"FAGGRA07_SH_05","FAGGRA","SH","FAGGRA07_SH",20,12,1,38,31,7
"FAGGRA07_SH_10","FAGGRA","SH","FAGGRA07_SH",15,12,0,61,29,32
"FAGGRA07_SH_11","FAGGRA","SH","FAGGRA07_SH",15,8,0,82,75,7
"FAGGRA08_SH_06","FAGGRA","SH","FAGGRA08_SH",15,12,1,43,37,6
"FAGGRA08_SH_11","FAGGRA","SH","FAGGRA08_SH",20,12,1,45,38,7
"FAGGRA09_HF_01","FAGGRA","HF","FAGGRA09_HF",20,12,0,53,39,14
"FAGGRA09_HF_02","FAGGRA","HF","FAGGRA09_HF",15,8,0,75,47,28
"FAGGRA09_HF_05","FAGGRA","HF","FAGGRA09_HF",15,12,0,68,54,14
"FAGGRA09_HF_08","FAGGRA","HF","FAGGRA09_HF",15,12,2,43,30,13
"FAGGRA09_HF_12","FAGGRA","HF","FAGGRA09_HF",15,12,1,37,22,15
"FAGGRA10_HF_02","FAGGRA","HF","FAGGRA10_HF",15,12,0,48,43,5
"FAGGRA10_HF_06","FAGGRA","HF","FAGGRA10_HF",15,8,0,82,68,14
"FAGGRA10_HF_08","FAGGRA","HF","FAGGRA10_HF",20,12,2,36,27,9
"FAGGRA10_HF_11","FAGGRA","HF","FAGGRA10_HF",15,12,2,43,30,13
"FAGGRA11_HF_01","FAGGRA","HF","FAGGRA11_HF",15,12,2,43,30,13
"FAGGRA11_HF_02","FAGGRA","HF","FAGGRA11_HF",15,12,0,54,48,6
"FAGGRA11_HF_03","FAGGRA","HF","FAGGRA11_HF",15,8,1,52,44,8
"FAGGRA11_HF_07","FAGGRA","HF","FAGGRA11_HF",15,8,0,75,68,7
"FAGGRA13_HF_01","FAGGRA","HF","FAGGRA13_HF",15,8,1,52,30,22
"FAGGRA13_HF_03","FAGGRA","HF","FAGGRA13_HF",20,8,2,56,41,15
"FAGGRA13_HF_04","FAGGRA","HF","FAGGRA13_HF",15,12,1,43,30,13
"FAGGRA13_HF_07","FAGGRA","HF","FAGGRA13_HF",15,8,0,68,42,26
"FAGGRA13_HF_08","FAGGRA","HF","FAGGRA13_HF",15,12,0,40,32,8
"FAGGRA13_HF_09","FAGGRA","HF","FAGGRA13_HF",20,12,0,39,26,13
"FAGGRA13_HF_12","FAGGRA","HF","FAGGRA13_HF",15,12,2,43,30,13
"FAGGRA14_HF_01","FAGGRA","HF","FAGGRA14_HF",15,12,2,50,37,13
"FAGGRA14_HF_05","FAGGRA","HF","FAGGRA14_HF",20,12,1,45,38,7
"FAGGRA14_HF_06","FAGGRA","HF","FAGGRA14_HF",15,12,0,61,48,13
"FAGGRA14_HF_07","FAGGRA","HF","FAGGRA14_HF",20,12,0,47,39,8
"FAGGRA14_HF_11","FAGGRA","HF","FAGGRA14_HF",15,8,0,82,68,14
"FRANIG01_HF_03","FRANIG","HF","FRANIG01_HF",20,12,0,33,26,7
"FRANIG01_HF_04","FRANIG","HF","FRANIG01_HF",15,12,0,48,34,14
"FRANIG01_SH_01","FRANIG","SH","FRANIG01_SH",15,12,0,54,40,14
"FRANIG01_SH_02","FRANIG","SH","FRANIG01_SH",20,12,0,29,26,3
"FRANIG01_SH_03","FRANIG","SH","FRANIG01_SH",20,8,0,40,34,6
"FRANIG01_SH_04","FRANIG","SH","FRANIG01_SH",15,8,0,68,39,29
"FRANIG02_SH_01","FRANIG","SH","FRANIG02_SH",15,8,0,68,42,26
"FRANIG02_SH_02","FRANIG","SH","FRANIG02_SH",20,8,0,40,34,6
"FRANIG02_SH_03","FRANIG","SH","FRANIG02_SH",15,12,0,48,34,14
"FRANIG02_SH_04","FRANIG","SH","FRANIG02_SH",20,12,0,33,26,7
"FRANIG03_HF_01","FRANIG","HF","FRANIG03_HF",20,8,0,56,40,16
"FRANIG03_HF_02","FRANIG","HF","FRANIG03_HF",15,8,0,82,47,35
"FRANIG03_HF_03","FRANIG","HF","FRANIG03_HF",20,12,0,53,39,14
"FRANIG03_HF_04","FRANIG","HF","FRANIG03_HF",15,12,0,61,40,21
"FRANIG04_HF_01","FRANIG","HF","FRANIG04_HF",15,12,0,61,54,7
"FRANIG04_HF_02","FRANIG","HF","FRANIG04_HF",20,12,0,39,33,6
"FRANIG04_HF_03","FRANIG","HF","FRANIG04_HF",20,8,0,43,34,9
"FRANIG04_HF_04","FRANIG","HF","FRANIG04_HF",15,8,0,75,53,22
"FRANIG05_SH_02","FRANIG","SH","FRANIG05_SH",20,8,0,40,34,6
"FRANIG05_SH_04","FRANIG","SH","FRANIG05_SH",20,12,0,39,33,6
"FRANIG06_HF_01","FRANIG","HF","FRANIG06_HF",20,12,0,33,29,4
"FRANIG06_HF_02","FRANIG","HF","FRANIG06_HF",15,12,0,48,34,14
"FRANIG06_HF_03","FRANIG","HF","FRANIG06_HF",20,8,0,40,34,6
"FRANIG06_HF_04","FRANIG","HF","FRANIG06_HF",15,8,0,68,47,21
"FRANIG06_SH_01","FRANIG","SH","FRANIG06_SH",20,12,0,29,26,3
"FRANIG06_SH_02","FRANIG","SH","FRANIG06_SH",20,8,0,29,26,3
"FRANIG06_SH_03","FRANIG","SH","FRANIG06_SH",15,12,0,40,34,6
"FRANIG06_SH_04","FRANIG","SH","FRANIG06_SH",15,8,0,68,39,29
"FRANIG08_HF_01","FRANIG","HF","FRANIG08_HF",15,8,0,68,39,29
"FRANIG08_HF_02","FRANIG","HF","FRANIG08_HF",20,12,0,39,33,6
"FRANIG08_HF_03","FRANIG","HF","FRANIG08_HF",15,12,0,54,34,20
"FRANIG08_HF_04","FRANIG","HF","FRANIG08_HF",20,8,0,40,34,6
"FRANIG08_SH_02","FRANIG","SH","FRANIG08_SH",20,8,0,56,34,22
"FRANIG08_SH_04","FRANIG","SH","FRANIG08_SH",15,12,0,54,40,14
"FRANIG09_SH_01","FRANIG","SH","FRANIG09_SH",20,12,0,39,33,6
"FRANIG09_SH_02","FRANIG","SH","FRANIG09_SH",15,12,0,48,40,8
"FRANIG09_SH_03","FRANIG","SH","FRANIG09_SH",15,8,0,68,47,21
"FRANIG09_SH_04","FRANIG","SH","FRANIG09_SH",20,8,0,40,34,6
"HAMVIR07_HF_01","HAMVIR","HF","HAMVIR07_HF",15,12,0,54,43,11
"HAMVIR08_HF_04","HAMVIR","HF","HAMVIR08_HF",15,8,0,68,47,21
"HAMVIR09_HF_02","HAMVIR","HF","HAMVIR09_HF",20,12,0,42,39,3
"HAMVIR09_HF_03","HAMVIR","HF","HAMVIR09_HF",15,12,0,61,54,7
"HAMVIR10_HF_01","HAMVIR","HF","HAMVIR10_HF",15,12,0,43,40,3
"HAMVIR10_HF_02","HAMVIR","HF","HAMVIR10_HF",15,8,0,68,53,15
"HAMVIR10_HF_03","HAMVIR","HF","HAMVIR10_HF",20,8,0,40,34,6
"HAMVIR10_HF_04","HAMVIR","HF","HAMVIR10_HF",20,12,0,33,29,4
"HAMVIR11_HF_03","HAMVIR","HF","HAMVIR11_HF",20,8,0,34,29,5
"HAMVIR11_HF_04","HAMVIR","HF","HAMVIR11_HF",15,12,0,40,34,6
"HAMVIR12_HF_01","HAMVIR","HF","HAMVIR12_HF",15,12,0,48,43,5
"HAMVIR12_HF_04","HAMVIR","HF","HAMVIR12_HF",20,8,0,43,40,3
"ILEMUC01_SH_01","ILEMUC","SH","ILEMUC01_SH",15,12,0,40,29,11
"ILEMUC01_SH_02","ILEMUC","SH","ILEMUC01_SH",20,12,0,18,13,5
"ILEMUC01_SH_04","ILEMUC","SH","ILEMUC01_SH",15,12,1,13,8,5
"ILEMUC01_SH_06","ILEMUC","SH","ILEMUC01_SH",15,8,2,30,13,17
"ILEMUC01_SH_08","ILEMUC","SH","ILEMUC01_SH",15,8,1,44,15,29
"ILEMUC01_SH_09","ILEMUC","SH","ILEMUC01_SH",15,8,0,39,13,26
"ILEMUC01_SH_10","ILEMUC","SH","ILEMUC01_SH",20,8,0,26,18,8
"ILEMUC01_SH_11","ILEMUC","SH","ILEMUC01_SH",20,12,2,27,14,13
"ILEMUC03_HF_01","ILEMUC","HF","ILEMUC03_HF",15,8,0,33,13,20
"ILEMUC03_HF_02","ILEMUC","HF","ILEMUC03_HF",15,8,1,30,15,15
"ILEMUC03_HF_03","ILEMUC","HF","ILEMUC03_HF",20,12,1,13,8,5
"ILEMUC03_HF_05","ILEMUC","HF","ILEMUC03_HF",15,12,0,29,20,9
"ILEMUC03_HF_06","ILEMUC","HF","ILEMUC03_HF",15,8,2,30,13,17
"ILEMUC03_HF_07","ILEMUC","HF","ILEMUC03_HF",15,12,2,23,13,10
"ILEMUC03_HF_08","ILEMUC","HF","ILEMUC03_HF",20,12,2,27,14,13
"ILEMUC03_HF_09","ILEMUC","HF","ILEMUC03_HF",20,8,2,24,13,11
"ILEMUC03_HF_10","ILEMUC","HF","ILEMUC03_HF",20,8,0,18,12,6
"ILEMUC03_HF_11","ILEMUC","HF","ILEMUC03_HF",15,12,1,17,8,9
"ILEMUC03_SH_01","ILEMUC","SH","ILEMUC03_SH",15,8,1,44,23,21
"ILEMUC03_SH_02","ILEMUC","SH","ILEMUC03_SH",15,12,0,29,20,9
"ILEMUC03_SH_03","ILEMUC","SH","ILEMUC03_SH",20,12,0,26,13,13
"ILEMUC03_SH_06","ILEMUC","SH","ILEMUC03_SH",20,12,1,13,8,5
"ILEMUC03_SH_07","ILEMUC","SH","ILEMUC03_SH",15,12,1,30,17,13
"ILEMUC03_SH_08","ILEMUC","SH","ILEMUC03_SH",15,8,0,39,33,6
"ILEMUC03_SH_09","ILEMUC","SH","ILEMUC03_SH",15,8,2,30,17,13
"ILEMUC03_SH_10","ILEMUC","SH","ILEMUC03_SH",15,12,2,23,13,10
"ILEMUC03_SH_11","ILEMUC","SH","ILEMUC03_SH",20,8,0,27,18,9
"ILEMUC04_HF_01","ILEMUC","HF","ILEMUC04_HF",15,8,0,39,21,18
"ILEMUC04_HF_02","ILEMUC","HF","ILEMUC04_HF",15,12,1,13,8,5
"ILEMUC04_HF_04","ILEMUC","HF","ILEMUC04_HF",15,8,2,30,13,17
"ILEMUC04_HF_05","ILEMUC","HF","ILEMUC04_HF",20,8,0,18,12,6
"ILEMUC04_HF_06","ILEMUC","HF","ILEMUC04_HF",15,12,0,20,12,8
"ILEMUC04_HF_08","ILEMUC","HF","ILEMUC04_HF",15,8,1,30,9,21
"ILEMUC04_HF_11","ILEMUC","HF","ILEMUC04_HF",20,12,1,13,8,5
"ILEMUC04_SH_01","ILEMUC","SH","ILEMUC04_SH",15,8,0,39,21,18
"ILEMUC04_SH_03","ILEMUC","SH","ILEMUC04_SH",20,12,1,13,8,5
"ILEMUC04_SH_04","ILEMUC","SH","ILEMUC04_SH",15,12,2,23,13,10
"ILEMUC04_SH_05","ILEMUC","SH","ILEMUC04_SH",15,8,1,30,15,15
"ILEMUC04_SH_06","ILEMUC","SH","ILEMUC04_SH",20,8,0,26,18,8
"ILEMUC04_SH_07","ILEMUC","SH","ILEMUC04_SH",20,8,2,24,13,11
"ILEMUC04_SH_08","ILEMUC","SH","ILEMUC04_SH",15,12,0,32,12,20
"ILEMUC04_SH_09","ILEMUC","SH","ILEMUC04_SH",15,12,1,13,8,5
"ILEMUC04_SH_11","ILEMUC","SH","ILEMUC04_SH",15,8,2,30,13,17
"ILEMUC05_HF_01","ILEMUC","HF","ILEMUC05_HF",20,12,1,13,8,5
"ILEMUC05_HF_02","ILEMUC","HF","ILEMUC05_HF",15,12,2,30,13,17
"ILEMUC05_HF_03","ILEMUC","HF","ILEMUC05_HF",15,8,2,30,13,17
"ILEMUC05_HF_04","ILEMUC","HF","ILEMUC05_HF",15,8,1,30,9,21
"ILEMUC05_HF_07","ILEMUC","HF","ILEMUC05_HF",20,12,2,27,14,13
"ILEMUC05_HF_09","ILEMUC","HF","ILEMUC05_HF",15,8,0,33,13,20
"ILEMUC05_HF_10","ILEMUC","HF","ILEMUC05_HF",15,12,0,32,20,12
"ILEMUC05_HF_11","ILEMUC","HF","ILEMUC05_HF",20,8,2,24,13,11
"ILEMUC05_HF_12","ILEMUC","HF","ILEMUC05_HF",15,12,1,22,8,14
"ILEMUC05_SH_01","ILEMUC","SH","ILEMUC05_SH",20,8,0,27,18,9
"ILEMUC05_SH_03","ILEMUC","SH","ILEMUC05_SH",15,8,0,39,13,26
"ILEMUC05_SH_04","ILEMUC","SH","ILEMUC05_SH",15,12,1,22,13,9
"ILEMUC05_SH_05","ILEMUC","SH","ILEMUC05_SH",15,12,0,34,20,14
"ILEMUC05_SH_08","ILEMUC","SH","ILEMUC05_SH",15,8,1,30,15,15
"ILEMUC05_SH_09","ILEMUC","SH","ILEMUC05_SH",15,12,2,23,13,10
"ILEMUC05_SH_10","ILEMUC","SH","ILEMUC05_SH",20,12,0,18,13,5
"ILEMUC05_SH_11","ILEMUC","SH","ILEMUC05_SH",20,12,1,13,8,5
"ILEMUC05_SH_12","ILEMUC","SH","ILEMUC05_SH",15,8,2,30,13,17
"ILEMUC06_HF_02","ILEMUC","HF","ILEMUC06_HF",20,8,0,34,26,8
"ILEMUC06_HF_03","ILEMUC","HF","ILEMUC06_HF",15,12,1,37,17,20
"ILEMUC06_HF_04","ILEMUC","HF","ILEMUC06_HF",15,8,2,44,30,14
"ILEMUC06_HF_05","ILEMUC","HF","ILEMUC06_HF",20,12,0,26,18,8
"ILEMUC06_HF_06","ILEMUC","HF","ILEMUC06_HF",15,8,1,44,23,21
"ILEMUC06_HF_07","ILEMUC","HF","ILEMUC06_HF",15,12,0,43,34,9
"ILEMUC06_HF_08","ILEMUC","HF","ILEMUC06_HF",20,12,2,27,14,13
"ILEMUC06_HF_09","ILEMUC","HF","ILEMUC06_HF",15,12,2,37,23,14
"ILEMUC06_HF_12","ILEMUC","HF","ILEMUC06_HF",15,8,0,68,33,35
"ILEMUC06_SH_01","ILEMUC","SH","ILEMUC06_SH",15,12,1,22,13,9
"ILEMUC06_SH_03","ILEMUC","SH","ILEMUC06_SH",15,8,1,30,15,15
"ILEMUC06_SH_04","ILEMUC","SH","ILEMUC06_SH",15,12,2,23,13,10
"ILEMUC06_SH_06","ILEMUC","SH","ILEMUC06_SH",20,8,0,27,12,15
"ILEMUC06_SH_07","ILEMUC","SH","ILEMUC06_SH",15,12,0,32,20,12
"ILEMUC06_SH_08","ILEMUC","SH","ILEMUC06_SH",20,12,1,13,8,5
"ILEMUC06_SH_11","ILEMUC","SH","ILEMUC06_SH",15,8,0,33,21,12
"ILEMUC06_SH_12","ILEMUC","SH","ILEMUC06_SH",15,8,2,30,13,17
"ILEMUC07_HF_01","ILEMUC","HF","ILEMUC07_HF",20,12,0,18,13,5
"ILEMUC07_HF_02","ILEMUC","HF","ILEMUC07_HF",15,8,0,39,13,26
"ILEMUC07_HF_03","ILEMUC","HF","ILEMUC07_HF",20,8,2,24,13,11
"ILEMUC07_HF_04","ILEMUC","HF","ILEMUC07_HF",15,8,2,30,17,13
"ILEMUC07_HF_05","ILEMUC","HF","ILEMUC07_HF",20,8,0,27,12,15
"ILEMUC07_HF_06","ILEMUC","HF","ILEMUC07_HF",15,8,1,30,9,21
"ILEMUC07_HF_08","ILEMUC","HF","ILEMUC07_HF",15,12,1,22,8,14
"ILEMUC07_HF_10","ILEMUC","HF","ILEMUC07_HF",15,12,0,29,20,9
"ILEMUC07_HF_11","ILEMUC","HF","ILEMUC07_HF",20,12,1,13,8,5
"ILEMUC07_HF_12","ILEMUC","HF","ILEMUC07_HF",15,12,2,23,13,10
"ILEMUC07_SH_01","ILEMUC","SH","ILEMUC07_SH",15,8,0,33,21,12
"ILEMUC07_SH_02","ILEMUC","SH","ILEMUC07_SH",20,8,0,26,13,13
"ILEMUC07_SH_04","ILEMUC","SH","ILEMUC07_SH",15,8,1,30,15,15
"ILEMUC07_SH_05","ILEMUC","SH","ILEMUC07_SH",20,8,2,24,13,11
"ILEMUC07_SH_06","ILEMUC","SH","ILEMUC07_SH",15,8,2,23,13,10
"ILEMUC07_SH_07","ILEMUC","SH","ILEMUC07_SH",15,12,0,32,20,12
"ILEMUC07_SH_08","ILEMUC","SH","ILEMUC07_SH",15,12,1,13,8,5
"ILEMUC07_SH_09","ILEMUC","SH","ILEMUC07_SH",20,12,1,13,8,5
"ILEMUC07_SH_10","ILEMUC","SH","ILEMUC07_SH",15,12,2,23,13,10
"ILEMUC07_SH_11","ILEMUC","SH","ILEMUC07_SH",20,12,2,20,14,6
"ILEMUC07_SH_12","ILEMUC","SH","ILEMUC07_SH",20,12,0,18,13,5
"ILEMUC08_HF_01","ILEMUC","HF","ILEMUC08_HF",15,12,2,30,13,17
"ILEMUC08_HF_02","ILEMUC","HF","ILEMUC08_HF",20,8,2,31,24,7
"ILEMUC08_HF_03","ILEMUC","HF","ILEMUC08_HF",15,12,0,32,20,12
"ILEMUC08_HF_04","ILEMUC","HF","ILEMUC08_HF",15,8,2,44,13,31
"ILEMUC08_HF_05","ILEMUC","HF","ILEMUC08_HF",15,8,1,30,15,15
"ILEMUC08_HF_06","ILEMUC","HF","ILEMUC08_HF",20,12,0,18,13,5
"ILEMUC08_HF_08","ILEMUC","HF","ILEMUC08_HF",20,8,0,27,18,9
"ILEMUC08_HF_09","ILEMUC","HF","ILEMUC08_HF",20,12,1,13,8,5
"ILEMUC08_HF_10","ILEMUC","HF","ILEMUC08_HF",15,12,1,13,8,5
"ILEMUC08_HF_11","ILEMUC","HF","ILEMUC08_HF",15,8,0,42,33,9
"ILEMUC08_HF_12","ILEMUC","HF","ILEMUC08_HF",20,12,2,20,14,6
"KALANG03_SH_02","KALANG","SH","KALANG03_SH",20,8,0,43,27,16
"KALANG11_HF_04","KALANG","HF","KALANG11_HF",15,8,0,68,33,35
"KALANG14_HF_01","KALANG","HF","KALANG14_HF",20,8,0,34,27,7
"KALANG99_SH_02","KALANG","SH","KALANG99_SH",15,8,0,82,33,49
"LONCAN01_HF_01","LONCAN","HF","LONCAN01_HF",15,12,0,29,12,17
"LONCAN01_HF_02","LONCAN","HF","LONCAN01_HF",15,8,0,33,13,20
"LONCAN01_HF_03","LONCAN","HF","LONCAN01_HF",20,12,0,18,13,5
"LONCAN01_HF_04","LONCAN","HF","LONCAN01_HF",20,8,0,26,13,13
"LONCAN01_SH_01","LONCAN","SH","LONCAN01_SH",20,8,0,18,12,6
"LONCAN01_SH_03","LONCAN","SH","LONCAN01_SH",20,12,0,18,13,5
"LONCAN01_SH_04","LONCAN","SH","LONCAN01_SH",15,8,0,33,13,20
"LONCAN02_HF_01","LONCAN","HF","LONCAN02_HF",15,12,0,29,20,9
"LONCAN02_HF_02","LONCAN","HF","LONCAN02_HF",20,12,0,33,26,7
"LONCAN02_HF_03","LONCAN","HF","LONCAN02_HF",20,8,0,27,18,9
"LONCAN02_HF_04","LONCAN","HF","LONCAN02_HF",15,8,0,33,13,20
"LONCAN04_HF_02","LONCAN","HF","LONCAN04_HF",15,8,0,33,21,12
"LONCAN04_HF_03","LONCAN","HF","LONCAN04_HF",20,8,0,18,12,6
"LONCAN05_HF_01","LONCAN","HF","LONCAN05_HF",15,12,0,29,20,9
"LONCAN05_HF_02","LONCAN","HF","LONCAN05_HF",20,8,0,27,12,15
"LONCAN05_HF_03","LONCAN","HF","LONCAN05_HF",20,12,0,26,13,13
"LONCAN05_HF_04","LONCAN","HF","LONCAN05_HF",15,8,0,39,21,18
"LONCAN05_SH_01","LONCAN","SH","LONCAN05_SH",15,12,0,29,12,17
"LONCAN05_SH_02","LONCAN","SH","LONCAN05_SH",20,12,0,18,13,5
"LONCAN05_SH_03","LONCAN","SH","LONCAN05_SH",15,8,0,33,13,20
"LONCAN05_SH_04","LONCAN","SH","LONCAN05_SH",20,8,0,27,12,15
"LONCAN06_HF_01","LONCAN","HF","LONCAN06_HF",20,8,0,27,12,15
"LONCAN06_HF_02","LONCAN","HF","LONCAN06_HF",15,8,0,33,13,20
"LONCAN06_HF_03","LONCAN","HF","LONCAN06_HF",15,12,0,29,20,9
"LONCAN07_HF_02","LONCAN","HF","LONCAN07_HF",15,8,0,68,53,15
"LONCAN07_HF_03","LONCAN","HF","LONCAN07_HF",15,12,0,20,12,8
"LONCAN07_HF_04","LONCAN","HF","LONCAN07_HF",20,8,0,27,6,21
"LONCAN99_SH_02","LONCAN","SH","LONCAN99_SH",15,8,0,33,21,12
"LONCAN99_SH_04","LONCAN","SH","LONCAN99_SH",15,12,0,32,20,12
"LYOLIG05_HF_01","LYOLIG","HF","LYOLIG05_HF",20,12,0,53,39,14
"LYOLIG05_HF_04","LYOLIG","HF","LYOLIG05_HF",20,8,0,18,12,6
"LYOLIG06_HF_01","LYOLIG","HF","LYOLIG06_HF",20,8,0,43,26,17
"LYOLIG06_HF_02","LYOLIG","HF","LYOLIG06_HF",15,12,0,61,40,21
"LYOLIG06_HF_03","LYOLIG","HF","LYOLIG06_HF",15,8,0,82,39,43
"LYOLIG06_HF_04","LYOLIG","HF","LYOLIG06_HF",20,12,0,39,26,13
"LYOLIG07_HF_01","LYOLIG","HF","LYOLIG07_HF",20,12,0,39,26,13
"LYOLIG07_HF_02","LYOLIG","HF","LYOLIG07_HF",20,8,0,43,27,16
"LYOLIG07_HF_03","LYOLIG","HF","LYOLIG07_HF",15,12,0,54,12,42
"LYOLIG07_HF_04","LYOLIG","HF","LYOLIG07_HF",15,8,0,82,47,35
"LYOLIG08_HF_01","LYOLIG","HF","LYOLIG08_HF",20,8,0,34,27,7
"LYOLIG08_HF_02","LYOLIG","HF","LYOLIG08_HF",15,12,0,54,32,22
"LYOLIG08_HF_03","LYOLIG","HF","LYOLIG08_HF",15,8,0,68,42,26
"LYOLIG08_HF_04","LYOLIG","HF","LYOLIG08_HF",20,12,0,42,26,16
"LYOLIG09_HF_01","LYOLIG","HF","LYOLIG09_HF",15,8,0,68,33,35
"LYOLIG09_HF_02","LYOLIG","HF","LYOLIG09_HF",20,12,0,29,26,3
"LYOLIG09_HF_03","LYOLIG","HF","LYOLIG09_HF",15,12,0,61,32,29
"LYOLIG09_HF_04","LYOLIG","HF","LYOLIG09_HF",20,8,0,34,18,16
"LYOLIG33_HF_01","LYOLIG","HF","LYOLIG33_HF",15,8,0,68,39,29
"LYOLIG33_HF_02","LYOLIG","HF","LYOLIG33_HF",15,12,0,54,34,20
"LYOLIG33_HF_03","LYOLIG","HF","LYOLIG33_HF",20,12,0,29,26,3
"LYOLIG33_HF_04","LYOLIG","HF","LYOLIG33_HF",20,8,0,34,27,7
"NYSSYL03_HF_01","NYSSYL","HF","NYSSYL03_HF",15,8,0,75,39,36
"NYSSYL03_HF_02","NYSSYL","HF","NYSSYL03_HF",20,8,0,43,29,14
"NYSSYL03_HF_03","NYSSYL","HF","NYSSYL03_HF",15,12,0,54,32,22
"NYSSYL03_HF_04","NYSSYL","HF","NYSSYL03_HF",20,12,0,39,26,13
"NYSSYL06_HF_01","NYSSYL","HF","NYSSYL06_HF",20,12,0,47,26,21
"NYSSYL06_HF_03","NYSSYL","HF","NYSSYL06_HF",15,8,0,75,39,36
"NYSSYL06_HF_04","NYSSYL","HF","NYSSYL06_HF",15,12,0,61,32,29
"NYSSYL08_HF_01","NYSSYL","HF","NYSSYL08_HF",20,12,0,39,29,10
"NYSSYL08_HF_02","NYSSYL","HF","NYSSYL08_HF",15,12,0,54,34,20
"NYSSYL08_HF_03","NYSSYL","HF","NYSSYL08_HF",15,8,0,75,33,42
"NYSSYL08_HF_04","NYSSYL","HF","NYSSYL08_HF",20,8,0,43,26,17
"NYSSYL10_HF_01","NYSSYL","HF","NYSSYL10_HF",15,12,0,48,29,19
"NYSSYL10_HF_02","NYSSYL","HF","NYSSYL10_HF",15,8,0,68,39,29
"NYSSYL10_HF_03","NYSSYL","HF","NYSSYL10_HF",20,12,0,33,26,7
"NYSSYL10_HF_04","NYSSYL","HF","NYSSYL10_HF",20,8,0,40,34,6
"NYSSYL13_HF_01","NYSSYL","HF","NYSSYL13_HF",20,12,0,47,26,21
"NYSSYL13_HF_02","NYSSYL","HF","NYSSYL13_HF",15,8,0,82,47,35
"NYSSYL13_HF_03","NYSSYL","HF","NYSSYL13_HF",20,8,0,56,34,22
"NYSSYL13_HF_04","NYSSYL","HF","NYSSYL13_HF",15,12,0,54,34,20
"NYSSYL14_HF_01","NYSSYL","HF","NYSSYL14_HF",15,12,0,48,29,19
"NYSSYL14_HF_02","NYSSYL","HF","NYSSYL14_HF",20,8,0,34,26,8
"NYSSYL14_HF_03","NYSSYL","HF","NYSSYL14_HF",20,12,0,33,26,7
"NYSSYL14_HF_04","NYSSYL","HF","NYSSYL14_HF",15,8,0,68,33,35
"POPGRA01_SH_01","POPGRA","SH","POPGRA01_SH",15,8,1,44,15,29
"POPGRA01_SH_02","POPGRA","SH","POPGRA01_SH",20,12,1,24,13,11
"POPGRA01_SH_03","POPGRA","SH","POPGRA01_SH",15,12,0,68,48,20
"POPGRA01_SH_04","POPGRA","SH","POPGRA01_SH",20,12,2,27,20,7
"POPGRA01_SH_05","POPGRA","SH","POPGRA01_SH",20,8,0,56,34,22
"POPGRA01_SH_06","POPGRA","SH","POPGRA01_SH",15,8,2,52,23,29
"POPGRA01_SH_07","POPGRA","SH","POPGRA01_SH",20,8,2,31,24,7
"POPGRA01_SH_08","POPGRA","SH","POPGRA01_SH",15,8,0,75,53,22
"POPGRA01_SH_09","POPGRA","SH","POPGRA01_SH",15,12,2,37,23,14
"POPGRA01_SH_12","POPGRA","SH","POPGRA01_SH",20,12,0,47,33,14
"POPGRA02_HF_01","POPGRA","HF","POPGRA02_HF",15,12,1,30,17,13
"POPGRA02_HF_02","POPGRA","HF","POPGRA02_HF",15,8,1,44,9,35
"POPGRA02_HF_04","POPGRA","HF","POPGRA02_HF",20,12,2,27,14,13
"POPGRA02_HF_06","POPGRA","HF","POPGRA02_HF",15,8,0,68,42,26
"POPGRA02_HF_09","POPGRA","HF","POPGRA02_HF",20,8,0,40,34,6
"POPGRA02_HF_11","POPGRA","HF","POPGRA02_HF",20,12,1,17,8,9
"POPGRA02_HF_12","POPGRA","HF","POPGRA02_HF",15,12,0,54,34,20
"POPGRA02_SH_01","POPGRA","SH","POPGRA02_SH",15,12,0,61,43,18
"POPGRA02_SH_03","POPGRA","SH","POPGRA02_SH",20,12,1,24,13,11
"POPGRA02_SH_04","POPGRA","SH","POPGRA02_SH",20,8,0,56,40,16
"POPGRA02_SH_05","POPGRA","SH","POPGRA02_SH",15,8,2,44,23,21
"POPGRA02_SH_06","POPGRA","SH","POPGRA02_SH",15,12,1,51,37,14
"POPGRA02_SH_07","POPGRA","SH","POPGRA02_SH",15,12,2,37,23,14
"POPGRA02_SH_08","POPGRA","SH","POPGRA02_SH",20,8,2,31,24,7
"POPGRA02_SH_10","POPGRA","SH","POPGRA02_SH",15,8,0,75,68,7
"POPGRA02_SH_11","POPGRA","SH","POPGRA02_SH",20,12,0,42,33,9
"POPGRA02_SH_12","POPGRA","SH","POPGRA02_SH",20,12,2,27,14,13
"POPGRA03_HF_01","POPGRA","HF","POPGRA03_HF",20,12,0,47,39,8
"POPGRA03_HF_02","POPGRA","HF","POPGRA03_HF",15,12,2,43,23,20
"POPGRA03_HF_03","POPGRA","HF","POPGRA03_HF",15,12,0,68,54,14
"POPGRA03_HF_04","POPGRA","HF","POPGRA03_HF",15,8,0,68,13,55
"POPGRA03_HF_05","POPGRA","HF","POPGRA03_HF",20,8,0,56,43,13
"POPGRA03_HF_06","POPGRA","HF","POPGRA03_HF",20,12,2,27,20,7
"POPGRA03_HF_08","POPGRA","HF","POPGRA03_HF",20,12,1,31,24,7
"POPGRA03_HF_09","POPGRA","HF","POPGRA03_HF",20,8,2,41,24,17
"POPGRA03_HF_10","POPGRA","HF","POPGRA03_HF",15,8,1,44,23,21
"POPGRA03_HF_11","POPGRA","HF","POPGRA03_HF",15,12,1,51,30,21
"POPGRA04_SH_01","POPGRA","SH","POPGRA04_SH",15,8,2,52,30,22
"POPGRA04_SH_02","POPGRA","SH","POPGRA04_SH",15,8,0,82,68,14
"POPGRA04_SH_08","POPGRA","SH","POPGRA04_SH",15,12,1,51,30,21
"POPGRA04_SH_10","POPGRA","SH","POPGRA04_SH",20,12,0,42,33,9
"POPGRA04_SH_11","POPGRA","SH","POPGRA04_SH",15,12,0,68,54,14
"POPGRA05_HF_01","POPGRA","HF","POPGRA05_HF",20,8,2,50,41,9
"POPGRA05_HF_02","POPGRA","HF","POPGRA05_HF",20,12,0,47,39,8
"POPGRA05_HF_03","POPGRA","HF","POPGRA05_HF",15,8,0,82,68,14
"POPGRA05_HF_04","POPGRA","HF","POPGRA05_HF",20,12,2,36,27,9
"POPGRA05_HF_05","POPGRA","HF","POPGRA05_HF",15,12,1,57,43,14
"POPGRA05_HF_08","POPGRA","HF","POPGRA05_HF",15,12,0,82,68,14
"POPGRA05_HF_10","POPGRA","HF","POPGRA05_HF",20,12,1,38,24,14
"POPGRA05_HF_12","POPGRA","HF","POPGRA05_HF",20,8,0,56,40,16
"POPGRA05_SH_02","POPGRA","SH","POPGRA05_SH",15,8,1,44,23,21
"POPGRA05_SH_03","POPGRA","SH","POPGRA05_SH",20,12,0,39,33,6
"POPGRA05_SH_04","POPGRA","SH","POPGRA05_SH",15,12,0,68,48,20
"POPGRA05_SH_08","POPGRA","SH","POPGRA05_SH",20,8,0,56,40,16
"POPGRA05_SH_10","POPGRA","SH","POPGRA05_SH",20,12,1,24,13,11
"POPGRA05_SH_11","POPGRA","SH","POPGRA05_SH",15,12,1,30,13,17
"POPGRA06_HF_01","POPGRA","HF","POPGRA06_HF",15,12,0,68,54,14
"POPGRA06_HF_03","POPGRA","HF","POPGRA06_HF",15,12,1,43,30,13
"POPGRA06_HF_06","POPGRA","HF","POPGRA06_HF",20,8,2,41,31,10
"POPGRA06_HF_07","POPGRA","HF","POPGRA06_HF",20,12,0,47,39,8
"POPGRA06_HF_09","POPGRA","HF","POPGRA06_HF",20,8,0,56,34,22
"POPGRA06_HF_10","POPGRA","HF","POPGRA06_HF",15,12,2,50,37,13
"POPGRA06_HF_11","POPGRA","HF","POPGRA06_HF",20,12,1,31,24,7
"POPGRA06_HF_12","POPGRA","HF","POPGRA06_HF",20,12,2,36,27,9
"POPGRA06_SH_01","POPGRA","SH","POPGRA06_SH",20,12,2,27,14,13
"POPGRA06_SH_02","POPGRA","SH","POPGRA06_SH",15,8,1,44,23,21
"POPGRA06_SH_03","POPGRA","SH","POPGRA06_SH",20,12,1,24,17,7
"POPGRA06_SH_07","POPGRA","SH","POPGRA06_SH",20,8,0,56,40,16
"POPGRA06_SH_08","POPGRA","SH","POPGRA06_SH",15,12,0,74,54,20
"POPGRA06_SH_11","POPGRA","SH","POPGRA06_SH",15,12,1,37,22,15
"POPGRA06_SH_12","POPGRA","SH","POPGRA06_SH",20,12,0,47,39,8
"POPGRA07_HF_01","POPGRA","HF","POPGRA07_HF",15,12,1,43,30,13
"POPGRA07_HF_02","POPGRA","HF","POPGRA07_HF",15,8,1,52,44,8
"POPGRA07_HF_03","POPGRA","HF","POPGRA07_HF",20,8,0,56,40,16
"POPGRA07_HF_06","POPGRA","HF","POPGRA07_HF",15,12,2,50,37,13
"POPGRA07_HF_08","POPGRA","HF","POPGRA07_HF",20,12,1,31,24,7
"POPGRA07_HF_11","POPGRA","HF","POPGRA07_HF",15,8,0,68,13,55
"POPGRA08_SH_01","POPGRA","SH","POPGRA08_SH",20,12,1,24,13,11
"POPGRA08_SH_03","POPGRA","SH","POPGRA08_SH",20,8,0,43,34,9
"POPGRA08_SH_04","POPGRA","SH","POPGRA08_SH",15,12,1,22,13,9
"POPGRA08_SH_06","POPGRA","SH","POPGRA08_SH",15,12,2,37,23,14
"POPGRA08_SH_07","POPGRA","SH","POPGRA08_SH",15,8,1,44,15,29
"POPGRA08_SH_08","POPGRA","SH","POPGRA08_SH",15,8,2,44,23,21
"POPGRA08_SH_09","POPGRA","SH","POPGRA08_SH",15,12,0,61,40,21
"POPGRA08_SH_10","POPGRA","SH","POPGRA08_SH",20,12,0,42,33,9
"POPGRA08_SH_11","POPGRA","SH","POPGRA08_SH",15,8,0,75,13,62
"PRUPEN02_SH_01","PRUPEN","SH","PRUPEN02_SH",15,8,0,42,13,29
"PRUPEN02_SH_02","PRUPEN","SH","PRUPEN02_SH",15,12,0,32,12,20
"PRUPEN02_SH_03","PRUPEN","SH","PRUPEN02_SH",20,8,0,26,12,14
"PRUPEN02_SH_04","PRUPEN","SH","PRUPEN02_SH",20,12,0,18,13,5
"PRUPEN04_HF_01","PRUPEN","HF","PRUPEN04_HF",15,8,0,33,21,12
"PRUPEN04_HF_02","PRUPEN","HF","PRUPEN04_HF",15,12,0,48,20,28
"PRUPEN04_HF_03","PRUPEN","HF","PRUPEN04_HF",20,12,0,18,13,5
"PRUPEN04_SH_01","PRUPEN","SH","PRUPEN04_SH",20,12,0,29,13,16
"PRUPEN04_SH_04","PRUPEN","SH","PRUPEN04_SH",15,8,0,39,21,18
"PRUPEN05_HF_01","PRUPEN","HF","PRUPEN05_HF",15,12,0,20,12,8
"PRUPEN05_HF_02","PRUPEN","HF","PRUPEN05_HF",15,8,0,33,13,20
"PRUPEN05_HF_03","PRUPEN","HF","PRUPEN05_HF",20,12,0,18,13,5
"PRUPEN05_HF_04","PRUPEN","HF","PRUPEN05_HF",20,8,0,18,12,6
"PRUPEN06_HF_01","PRUPEN","HF","PRUPEN06_HF",15,12,0,32,12,20
"PRUPEN06_HF_02","PRUPEN","HF","PRUPEN06_HF",15,8,0,39,13,26
"PRUPEN06_HF_03","PRUPEN","HF","PRUPEN06_HF",20,12,0,18,13,5
"PRUPEN06_HF_04","PRUPEN","HF","PRUPEN06_HF",20,8,0,27,18,9
"PRUPEN06_SH_01","PRUPEN","SH","PRUPEN06_SH",15,12,0,32,12,20
"PRUPEN06_SH_03","PRUPEN","SH","PRUPEN06_SH",20,12,0,18,13,5
"PRUPEN07_HF_01","PRUPEN","HF","PRUPEN07_HF",20,12,0,26,13,13
"PRUPEN07_HF_02","PRUPEN","HF","PRUPEN07_HF",15,8,0,68,21,47
"PRUPEN07_HF_03","PRUPEN","HF","PRUPEN07_HF",20,8,0,34,18,16
"PRUPEN07_HF_04","PRUPEN","HF","PRUPEN07_HF",15,12,0,34,20,14
"PRUPEN08_HF_01","PRUPEN","HF","PRUPEN08_HF",15,12,0,43,32,11
"PRUPEN08_HF_02","PRUPEN","HF","PRUPEN08_HF",15,8,0,33,13,20
"PRUPEN08_SH_02","PRUPEN","SH","PRUPEN08_SH",15,12,0,34,20,14
"PRUPEN08_SH_04","PRUPEN","SH","PRUPEN08_SH",15,8,0,47,13,34
"PRUPEN09_HF_01","PRUPEN","HF","PRUPEN09_HF",20,12,0,26,18,8
"PRUPEN09_HF_02","PRUPEN","HF","PRUPEN09_HF",15,8,0,68,13,55
"PRUPEN09_HF_03","PRUPEN","HF","PRUPEN09_HF",15,12,0,40,32,8
"PRUPEN09_HF_04","PRUPEN","HF","PRUPEN09_HF",20,8,0,34,27,7
"PRUPEN09_SH_01","PRUPEN","SH","PRUPEN09_SH",20,8,0,27,6,21
"PRUPEN09_SH_02","PRUPEN","SH","PRUPEN09_SH",15,12,0,29,12,17
"PRUPEN09_SH_03","PRUPEN","SH","PRUPEN09_SH",20,12,0,18,13,5
"PRUPEN09_SH_04","PRUPEN","SH","PRUPEN09_SH",15,8,0,33,13,20
"PRUPEN12_HF_02","PRUPEN","HF","PRUPEN12_HF",15,12,0,32,20,12
"PRUPEN12_HF_03","PRUPEN","HF","PRUPEN12_HF",20,12,0,26,13,13
"PRUPEN12_HF_04","PRUPEN","HF","PRUPEN12_HF",15,8,0,33,21,12
"PRUPEN13_HF_01","PRUPEN","HF","PRUPEN13_HF",15,8,0,39,21,18
"PRUPEN13_HF_02","PRUPEN","HF","PRUPEN13_HF",15,12,0,32,20,12
"PRUPEN13_HF_03","PRUPEN","HF","PRUPEN13_HF",20,8,0,27,12,15
"PRUPEN13_HF_04","PRUPEN","HF","PRUPEN13_HF",20,12,0,18,13,5
"QUEALB09_HF_01","QUEALB","HF","QUEALB09_HF",15,12,0,48,40,8
"QUEALB09_HF_03","QUEALB","HF","QUEALB09_HF",20,12,0,39,29,10
"QUEALB11_HF_02","QUEALB","HF","QUEALB11_HF",20,12,0,39,33,6
"QUEALB12_HF_03","QUEALB","HF","QUEALB12_HF",15,12,0,61,54,7
"QUEALB12_HF_04","QUEALB","HF","QUEALB12_HF",20,12,0,53,47,6
"QUEALB16_HF_01","QUEALB","HF","QUEALB16_HF",15,12,0,61,12,49
"QUEALB16_HF_02","QUEALB","HF","QUEALB16_HF",15,8,0,82,68,14
"QUEALB16_HF_03","QUEALB","HF","QUEALB16_HF",20,12,0,47,33,14
"QUEALB16_HF_04","QUEALB","HF","QUEALB16_HF",20,8,0,56,40,16
"QUERUB04_SH_01","QUERUB","SH","QUERUB04_SH",20,12,1,24,17,7
"QUERUB04_SH_02","QUERUB","SH","QUERUB04_SH",15,8,2,44,30,14
"QUERUB04_SH_03","QUERUB","SH","QUERUB04_SH",20,12,0,42,39,3
"QUERUB04_SH_04","QUERUB","SH","QUERUB04_SH",15,12,0,54,43,11
"QUERUB04_SH_06","QUERUB","SH","QUERUB04_SH",15,12,1,30,22,8
"QUERUB04_SH_07","QUERUB","SH","QUERUB04_SH",15,12,2,37,23,14
"QUERUB04_SH_08","QUERUB","SH","QUERUB04_SH",20,12,2,27,20,7
"QUERUB04_SH_09","QUERUB","SH","QUERUB04_SH",20,8,0,43,40,3
"QUERUB04_SH_11","QUERUB","SH","QUERUB04_SH",15,8,0,75,68,7
"QUERUB04_SH_12","QUERUB","SH","QUERUB04_SH",15,8,1,44,23,21
"QUERUB05_SH_01","QUERUB","SH","QUERUB05_SH",15,12,1,37,22,15
"QUERUB05_SH_02","QUERUB","SH","QUERUB05_SH",20,8,0,56,40,16
"QUERUB05_SH_05","QUERUB","SH","QUERUB05_SH",20,8,2,41,31,10
"QUERUB05_SH_06","QUERUB","SH","QUERUB05_SH",15,12,2,37,23,14
"QUERUB05_SH_07","QUERUB","SH","QUERUB05_SH",15,12,0,68,48,20
"QUERUB05_SH_08","QUERUB","SH","QUERUB05_SH",20,12,2,36,27,9
"QUERUB05_SH_10","QUERUB","SH","QUERUB05_SH",15,8,1,44,23,21
"QUERUB05_SH_11","QUERUB","SH","QUERUB05_SH",20,12,1,31,24,7
"QUERUB05_SH_12","QUERUB","SH","QUERUB05_SH",20,12,0,47,39,8
"QUERUB06_SH_02","QUERUB","SH","QUERUB06_SH",15,8,1,44,30,14
"QUERUB06_SH_03","QUERUB","SH","QUERUB06_SH",15,8,0,82,68,14
"QUERUB06_SH_06","QUERUB","SH","QUERUB06_SH",20,12,0,47,39,8
"QUERUB06_SH_08","QUERUB","SH","QUERUB06_SH",15,12,2,43,37,6
"QUERUB06_SH_09","QUERUB","SH","QUERUB06_SH",20,8,2,41,31,10
"QUERUB06_SH_10","QUERUB","SH","QUERUB06_SH",15,8,2,44,30,14
"QUERUB06_SH_12","QUERUB","SH","QUERUB06_SH",15,12,1,37,22,15
"QUERUB07_SH_01","QUERUB","SH","QUERUB07_SH",20,8,0,43,34,9
"QUERUB07_SH_02","QUERUB","SH","QUERUB07_SH",15,8,2,44,23,21
"QUERUB07_SH_03","QUERUB","SH","QUERUB07_SH",15,8,1,44,15,29
"QUERUB07_SH_06","QUERUB","SH","QUERUB07_SH",15,12,0,61,54,7
"QUERUB07_SH_07","QUERUB","SH","QUERUB07_SH",20,8,2,31,24,7
"QUERUB07_SH_10","QUERUB","SH","QUERUB07_SH",20,12,1,24,17,7
"QUERUB07_SH_11","QUERUB","SH","QUERUB07_SH",15,12,1,30,17,13
"QUERUB07_SH_12","QUERUB","SH","QUERUB07_SH",20,12,2,27,14,13
"QUERUB08_SH_01","QUERUB","SH","QUERUB08_SH",15,8,0,82,68,14
"QUERUB08_SH_03","QUERUB","SH","QUERUB08_SH",20,12,0,42,39,3
"QUERUB08_SH_05","QUERUB","SH","QUERUB08_SH",20,12,1,31,24,7
"QUERUB08_SH_08","QUERUB","SH","QUERUB08_SH",20,12,2,27,14,13
"QUERUB08_SH_10","QUERUB","SH","QUERUB08_SH",15,12,1,51,30,21
"QUERUB08_SH_11","QUERUB","SH","QUERUB08_SH",15,8,1,44,30,14
"QUERUB08_SH_12","QUERUB","SH","QUERUB08_SH",20,8,2,41,31,10
"QUERUB10_SH_01","QUERUB","SH","QUERUB10_SH",15,12,1,37,30,7
"QUERUB10_SH_02","QUERUB","SH","QUERUB10_SH",20,8,2,41,31,10
"QUERUB10_SH_03","QUERUB","SH","QUERUB10_SH",15,8,1,44,30,14
"QUERUB10_SH_04","QUERUB","SH","QUERUB10_SH",20,8,0,56,13,43
"QUERUB10_SH_06","QUERUB","SH","QUERUB10_SH",20,12,0,47,42,5
"QUERUB10_SH_07","QUERUB","SH","QUERUB10_SH",15,8,2,44,30,14
"QUERUB10_SH_12","QUERUB","SH","QUERUB10_SH",15,12,2,30,23,7
"QUERUB15_HF_01","QUERUB","HF","QUERUB15_HF",15,12,0,61,48,13
"QUERUB15_HF_02","QUERUB","HF","QUERUB15_HF",15,8,1,44,30,14
"QUERUB15_HF_04","QUERUB","HF","QUERUB15_HF",20,8,2,41,31,10
"QUERUB15_HF_05","QUERUB","HF","QUERUB15_HF",15,12,2,37,23,14
"QUERUB15_HF_09","QUERUB","HF","QUERUB15_HF",15,12,1,37,22,15
"QUERUB15_HF_10","QUERUB","HF","QUERUB15_HF",20,12,0,39,33,6
"QUERUB15_HF_11","QUERUB","HF","QUERUB15_HF",20,8,0,56,40,16
"QUERUB16_HF_03","QUERUB","HF","QUERUB16_HF",15,8,1,44,23,21
"QUERUB16_HF_04","QUERUB","HF","QUERUB16_HF",20,8,2,50,31,19
"QUERUB16_HF_05","QUERUB","HF","QUERUB16_HF",20,12,0,39,33,6
"QUERUB16_HF_06","QUERUB","HF","QUERUB16_HF",15,12,2,37,23,14
"QUERUB16_HF_07","QUERUB","HF","QUERUB16_HF",15,12,1,30,22,8
"QUERUB16_HF_08","QUERUB","HF","QUERUB16_HF",15,8,0,75,68,7
"QUERUB16_HF_09","QUERUB","HF","QUERUB16_HF",15,8,2,52,30,22
"QUERUB16_HF_10","QUERUB","HF","QUERUB16_HF",15,12,0,54,40,14
"QUERUB16_HF_11","QUERUB","HF","QUERUB16_HF",20,12,2,36,27,9
"QUERUB16_HF_12","QUERUB","HF","QUERUB16_HF",20,8,0,56,40,16
"QUERUB17_HF_02","QUERUB","HF","QUERUB17_HF",15,8,0,75,68,7
"QUERUB17_HF_04","QUERUB","HF","QUERUB17_HF",15,8,2,44,30,14
"QUERUB17_HF_05","QUERUB","HF","QUERUB17_HF",20,12,2,36,27,9
"QUERUB17_HF_07","QUERUB","HF","QUERUB17_HF",15,12,0,61,48,13
"QUERUB17_HF_08","QUERUB","HF","QUERUB17_HF",20,8,0,43,40,3
"QUERUB17_HF_09","QUERUB","HF","QUERUB17_HF",15,12,2,37,23,14
"QUERUB17_HF_10","QUERUB","HF","QUERUB17_HF",20,8,2,41,31,10
"QUERUB17_HF_11","QUERUB","HF","QUERUB17_HF",15,8,1,44,30,14
"QUERUB17_HF_12","QUERUB","HF","QUERUB17_HF",15,12,1,37,22,15
"QUERUB20_HF_01","QUERUB","HF","QUERUB20_HF",20,8,2,41,31,10
"QUERUB20_HF_02","QUERUB","HF","QUERUB20_HF",20,12,1,31,24,7
"QUERUB20_HF_03","QUERUB","HF","QUERUB20_HF",20,12,2,36,27,9
"QUERUB20_HF_05","QUERUB","HF","QUERUB20_HF",15,12,2,43,37,6
"QUERUB20_HF_07","QUERUB","HF","QUERUB20_HF",15,8,0,82,68,14
"QUERUB20_HF_10","QUERUB","HF","QUERUB20_HF",20,8,0,68,56,12
"QUERUB20_HF_11","QUERUB","HF","QUERUB20_HF",15,12,0,54,48,6
"QUERUB21_HF_02","QUERUB","HF","QUERUB21_HF",15,12,2,50,37,13
"QUERUB21_HF_03","QUERUB","HF","QUERUB21_HF",15,8,0,75,53,22
"QUERUB21_HF_05","QUERUB","HF","QUERUB21_HF",20,8,0,56,43,13
"QUERUB21_HF_06","QUERUB","HF","QUERUB21_HF",20,12,1,31,24,7
"QUERUB21_HF_07","QUERUB","HF","QUERUB21_HF",20,12,0,39,33,6
"QUERUB21_HF_09","QUERUB","HF","QUERUB21_HF",15,8,2,52,44,8
"QUERUB21_HF_10","QUERUB","HF","QUERUB21_HF",15,8,1,52,44,8
"QUERUB21_HF_11","QUERUB","HF","QUERUB21_HF",20,12,2,36,27,9
"QUERUB21_HF_12","QUERUB","HF","QUERUB21_HF",15,12,1,43,30,13
"QUERUB23_HF_01","QUERUB","HF","QUERUB23_HF",20,12,2,36,27,9
"QUERUB23_HF_05","QUERUB","HF","QUERUB23_HF",15,12,0,61,54,7
"QUERUB23_HF_07","QUERUB","HF","QUERUB23_HF",20,12,0,39,33,6
"QUERUB23_HF_08","QUERUB","HF","QUERUB23_HF",15,8,0,82,68,14
"QUERUB23_HF_09","QUERUB","HF","QUERUB23_HF",15,12,1,43,30,13
"QUERUB23_HF_10","QUERUB","HF","QUERUB23_HF",15,12,2,50,37,13
"QUERUB23_HF_12","QUERUB","HF","QUERUB23_HF",15,8,1,52,44,8
"QUEVEL01_HF_01","QUEVEL","HF","QUEVEL01_HF",20,8,0,56,43,13
"QUEVEL01_HF_02","QUEVEL","HF","QUEVEL01_HF",20,12,0,47,39,8
"QUEVEL01_HF_04","QUEVEL","HF","QUEVEL01_HF",15,8,0,82,68,14
"QUEVEL02_HF_01","QUEVEL","HF","QUEVEL02_HF",20,12,0,53,42,11
"QUEVEL02_HF_02","QUEVEL","HF","QUEVEL02_HF",15,8,0,75,68,7
"QUEVEL02_HF_03","QUEVEL","HF","QUEVEL02_HF",20,8,0,56,43,13
"QUEVEL02_HF_04","QUEVEL","HF","QUEVEL02_HF",15,12,0,61,43,18
"QUEVEL03_HF_01","QUEVEL","HF","QUEVEL03_HF",20,12,0,47,39,8
"QUEVEL03_HF_02","QUEVEL","HF","QUEVEL03_HF",15,8,0,82,75,7
"QUEVEL05_HF_02","QUEVEL","HF","QUEVEL05_HF",15,8,0,82,68,14
"QUEVEL06_HF_01","QUEVEL","HF","QUEVEL06_HF",20,8,0,43,40,3
"QUEVEL06_HF_02","QUEVEL","HF","QUEVEL06_HF",20,12,0,42,33,9
"QUEVEL06_HF_04","QUEVEL","HF","QUEVEL06_HF",15,12,0,61,48,13
"QUEVEL09_HF_03","QUEVEL","HF","QUEVEL09_HF",20,8,0,68,56,12
"RHAFRA01_HF_01","RHAFRA","HF","RHAFRA01_HF",15,12,0,40,34,6
"RHAFRA01_HF_03","RHAFRA","HF","RHAFRA01_HF",15,8,0,75,39,36
"RHAFRA02_HF_01","RHAFRA","HF","RHAFRA02_HF",15,8,0,68,39,29
"RHAFRA02_HF_02","RHAFRA","HF","RHAFRA02_HF",20,12,0,26,18,8
"RHAFRA02_HF_03","RHAFRA","HF","RHAFRA02_HF",20,8,0,34,27,7
"RHAFRA02_HF_04","RHAFRA","HF","RHAFRA02_HF",15,12,0,48,40,8
"RHAFRA12_HF_01","RHAFRA","HF","RHAFRA12_HF",15,12,0,34,32,2
"RHAFRA12_HF_02","RHAFRA","HF","RHAFRA12_HF",20,12,0,26,18,8
"RHAFRA16_HF_01","RHAFRA","HF","RHAFRA16_HF",20,12,0,29,26,3
"RHAFRA16_HF_02","RHAFRA","HF","RHAFRA16_HF",15,12,0,54,43,11
"RHAFRA17_HF_04","RHAFRA","HF","RHAFRA17_HF",20,8,0,29,27,2
"RHAFRA18_HF_01","RHAFRA","HF","RHAFRA18_HF",15,8,0,47,33,14
"RHAFRA18_HF_02","RHAFRA","HF","RHAFRA18_HF",20,12,0,26,18,8
"RHAFRA18_HF_03","RHAFRA","HF","RHAFRA18_HF",15,12,0,43,34,9
"RHAFRA18_HF_04","RHAFRA","HF","RHAFRA18_HF",20,8,0,29,18,11
"RHOPRI03_HF_01","RHOPRI","HF","RHOPRI03_HF",15,12,0,68,32,36
"RHOPRI03_HF_02","RHOPRI","HF","RHOPRI03_HF",20,8,0,56,27,29
"RHOPRI03_HF_03","RHOPRI","HF","RHOPRI03_HF",15,8,0,68,13,55
"RHOPRI03_HF_04","RHOPRI","HF","RHOPRI03_HF",20,12,0,47,13,34
"RHOPRI04_HF_01","RHOPRI","HF","RHOPRI04_HF",20,12,0,39,18,21
"RHOPRI04_HF_02","RHOPRI","HF","RHOPRI04_HF",15,8,0,68,33,35
"RHOPRI04_HF_03","RHOPRI","HF","RHOPRI04_HF",15,12,0,61,29,32
"RHOPRI04_HF_04","RHOPRI","HF","RHOPRI04_HF",20,8,0,68,27,41
"RHOPRI05_HF_01","RHOPRI","HF","RHOPRI05_HF",20,8,0,56,34,22
"RHOPRI05_HF_03","RHOPRI","HF","RHOPRI05_HF",15,12,0,61,32,29
"RHOPRI05_HF_04","RHOPRI","HF","RHOPRI05_HF",20,12,0,42,29,13
"RHOPRI06_HF_01","RHOPRI","HF","RHOPRI06_HF",20,8,0,29,26,3
"RHOPRI06_HF_02","RHOPRI","HF","RHOPRI06_HF",15,8,0,68,33,35
"RHOPRI06_HF_04","RHOPRI","HF","RHOPRI06_HF",15,12,0,40,34,6
"RHOPRI07_HF_01","RHOPRI","HF","RHOPRI07_HF",15,8,0,68,33,35
"RHOPRI07_HF_02","RHOPRI","HF","RHOPRI07_HF",20,8,0,29,27,2
"RHOPRI07_HF_03","RHOPRI","HF","RHOPRI07_HF",15,12,0,43,29,14
"RHOPRI07_HF_04","RHOPRI","HF","RHOPRI07_HF",20,12,0,33,26,7
"RHOPRI08_HF_01","RHOPRI","HF","RHOPRI08_HF",15,8,0,68,33,35
"RHOPRI08_HF_03","RHOPRI","HF","RHOPRI08_HF",20,8,0,34,12,22
"RHOPRI08_HF_04","RHOPRI","HF","RHOPRI08_HF",20,12,0,33,26,7
"SPIALB01_HF_01","SPIALB","HF","SPIALB01_HF",15,12,0,20,12,8
"SPIALB01_HF_03","SPIALB","HF","SPIALB01_HF",15,8,0,33,21,12
"SPIALB01_HF_04","SPIALB","HF","SPIALB01_HF",20,12,0,26,18,8
"SPIALB03_HF_02","SPIALB","HF","SPIALB03_HF",15,12,0,32,20,12
"SPIALB03_HF_03","SPIALB","HF","SPIALB03_HF",20,8,0,18,12,6
"SPIALB03_HF_04","SPIALB","HF","SPIALB03_HF",20,12,0,18,13,5
"SPIALB03_SH_01","SPIALB","SH","SPIALB03_SH",20,12,0,18,13,5
"SPIALB03_SH_04","SPIALB","SH","SPIALB03_SH",15,12,0,32,20,12
"SPIALB04_HF_01","SPIALB","HF","SPIALB04_HF",20,8,0,27,12,15
"SPIALB04_HF_02","SPIALB","HF","SPIALB04_HF",20,12,0,26,13,13
"SPIALB04_HF_03","SPIALB","HF","SPIALB04_HF",15,12,0,29,20,9
"SPIALB04_HF_04","SPIALB","HF","SPIALB04_HF",15,8,0,33,13,20
"SPIALB05_HF_01","SPIALB","HF","SPIALB05_HF",15,8,0,33,13,20
"SPIALB06_HF_02","SPIALB","HF","SPIALB06_HF",20,8,0,27,12,15
"SPIALB06_SH_02","SPIALB","SH","SPIALB06_SH",20,8,0,27,12,15
"SPIALB06_SH_04","SPIALB","SH","SPIALB06_SH",15,12,0,43,20,23
"SPIALB07_SH_01","SPIALB","SH","SPIALB07_SH",15,8,0,33,21,12
"SPIALB07_SH_02","SPIALB","SH","SPIALB07_SH",20,12,0,18,13,5
"SPIALB07_SH_03","SPIALB","SH","SPIALB07_SH",15,12,0,29,20,9
"SPIALB07_SH_04","SPIALB","SH","SPIALB07_SH",20,8,0,18,13,5
"SPIALB99_SH_01","SPIALB","SH","SPIALB99_SH",15,8,0,18,13,5
"SPIALB99_SH_02","SPIALB","SH","SPIALB99_SH",15,12,0,18,12,6
"SPIALB99_SH_03","SPIALB","SH","SPIALB99_SH",15,8,0,26,18,8
"VACMYR01_HF_01","VACMYR","HF","VACMYR01_HF",15,12,0,32,12,20
"VACMYR01_HF_02","VACMYR","HF","VACMYR01_HF",15,8,0,33,13,20
"VACMYR01_HF_03","VACMYR","HF","VACMYR01_HF",20,12,0,18,6,12
"VACMYR01_HF_04","VACMYR","HF","VACMYR01_HF",20,8,0,27,12,15
"VACMYR02_SH_01","VACMYR","SH","VACMYR02_SH",15,12,0,29,20,9
"VACMYR02_SH_02","VACMYR","SH","VACMYR02_SH",20,12,0,18,13,5
"VACMYR02_SH_03","VACMYR","SH","VACMYR02_SH",15,8,0,39,13,26
"VACMYR02_SH_04","VACMYR","SH","VACMYR02_SH",20,8,0,18,12,6
"VACMYR03_HF_01","VACMYR","HF","VACMYR03_HF",20,8,0,26,12,14
"VACMYR03_HF_02","VACMYR","HF","VACMYR03_HF",15,12,0,29,12,17
"VACMYR03_HF_03","VACMYR","HF","VACMYR03_HF",20,12,0,26,13,13
"VACMYR03_HF_04","VACMYR","HF","VACMYR03_HF",15,8,0,39,13,26
"VACMYR03_SH_03","VACMYR","SH","VACMYR03_SH",15,8,0,39,21,18
"VACMYR03_SH_04","VACMYR","SH","VACMYR03_SH",20,12,0,26,6,20
"VACMYR04_HF_01","VACMYR","HF","VACMYR04_HF",15,8,0,33,13,20
"VACMYR04_HF_02","VACMYR","HF","VACMYR04_HF",15,12,0,32,12,20
"VACMYR04_HF_03","VACMYR","HF","VACMYR04_HF",20,8,0,18,13,5
"VACMYR04_SH_01","VACMYR","SH","VACMYR04_SH",20,8,0,18,12,6
"VACMYR04_SH_02","VACMYR","SH","VACMYR04_SH",15,12,0,29,20,9
"VACMYR04_SH_03","VACMYR","SH","VACMYR04_SH",15,8,0,39,33,6
"VACMYR04_SH_04","VACMYR","SH","VACMYR04_SH",20,12,0,26,13,13
"VACMYR05_HF_01","VACMYR","HF","VACMYR05_HF",20,8,0,18,13,5
"VACMYR05_HF_02","VACMYR","HF","VACMYR05_HF",20,12,0,18,13,5
"VACMYR05_HF_03","VACMYR","HF","VACMYR05_HF",15,12,0,32,12,20
"VACMYR05_HF_04","VACMYR","HF","VACMYR05_HF",15,8,0,33,13,20
"VACMYR05_SH_01","VACMYR","SH","VACMYR05_SH",15,8,0,42,21,21
"VACMYR05_SH_02","VACMYR","SH","VACMYR05_SH",20,8,0,26,13,13
"VACMYR05_SH_03","VACMYR","SH","VACMYR05_SH",15,12,0,32,20,12
"VACMYR05_SH_04","VACMYR","SH","VACMYR05_SH",20,12,0,26,13,13
"VACMYR07_HF_01","VACMYR","HF","VACMYR07_HF",15,12,0,29,12,17
"VACMYR07_HF_03","VACMYR","HF","VACMYR07_HF",20,12,0,26,13,13
"VACMYR07_HF_04","VACMYR","HF","VACMYR07_HF",20,8,0,18,12,6
"VACMYR07_SH_01","VACMYR","SH","VACMYR07_SH",20,12,0,26,13,13
"VACMYR07_SH_03","VACMYR","SH","VACMYR07_SH",20,8,0,27,12,15
"VACMYR08_SH_01","VACMYR","SH","VACMYR08_SH",15,8,0,39,21,18
"VACMYR08_SH_02","VACMYR","SH","VACMYR08_SH",20,12,0,18,13,5
"VACMYR08_SH_03","VACMYR","SH","VACMYR08_SH",20,8,0,27,12,15
"VACMYR08_SH_04","VACMYR","SH","VACMYR08_SH",15,12,0,34,20,14
"VACMYR10_HF_01","VACMYR","HF","VACMYR10_HF",20,12,0,26,13,13
"VACMYR10_HF_02","VACMYR","HF","VACMYR10_HF",20,8,0,27,12,15
"VACMYR10_HF_03","VACMYR","HF","VACMYR10_HF",15,12,0,29,12,17
"VACMYR10_HF_04","VACMYR","HF","VACMYR10_HF",15,8,0,39,13,26
"VIBCAS01_SH_01","VIBCAS","SH","VIBCAS01_SH",20,8,0,18,12,6
"VIBCAS01_SH_04","VIBCAS","SH","VIBCAS01_SH",15,12,0,32,20,12
"VIBCAS02_HF_01","VIBCAS","HF","VIBCAS02_HF",15,12,0,68,12,56
"VIBCAS03_HF_08","VIBCAS","HF","VIBCAS03_HF",15,12,0,20,12,8
"VIBCAS03_HF_09","VIBCAS","HF","VIBCAS03_HF",15,8,0,39,33,6
"VIBCAS04_HF_05","VIBCAS","HF","VIBCAS04_HF",15,12,0,20,12,8
"VIBLAN03_HF_11","VIBLAN","HF","VIBLAN03_HF",15,8,0,39,33,6
"VIBLAN05_SH_10","VIBLAN","SH","VIBLAN05_SH",20,8,2,31,24,7
"VIBLAN09_SH_09","VIBLAN","SH","VIBLAN09_SH",15,12,2,16,13,3
"VIBLAN10_HF_07","VIBLAN","HF","VIBLAN10_HF",20,8,0,34,12,22
"ACEPEN01_HF_09","ACEPEN","HF","ACEPEN01_HF",20,8,1,31,16,15
"ACEPEN02_HF_08","ACEPEN","HF","ACEPEN02_HF",20,8,1,56,16,40
"ACEPEN03_HF_07","ACEPEN","HF","ACEPEN03_HF",20,8,1,24,8,16
"ACEPEN04_HF_04","ACEPEN","HF","ACEPEN04_HF",20,8,1,31,16,15
"ACEPEN04_SH_10","ACEPEN","SH","ACEPEN04_SH",20,8,1,50,24,26
"ACEPEN06_SH_12","ACEPEN","SH","ACEPEN06_SH",20,8,1,31,16,15
"ACEPEN07_SH_06","ACEPEN","SH","ACEPEN07_SH",20,8,1,38,16,22
"ACEPEN08_SH_08","ACEPEN","SH","ACEPEN08_SH",20,8,1,50,24,26
"ACEPEN09_SH_09","ACEPEN","SH","ACEPEN09_SH",20,8,1,50,16,34
"ACEPEN11_HF_10","ACEPEN","HF","ACEPEN11_HF",20,8,1,38,24,14
"ACEPEN11_SH_06","ACEPEN","SH","ACEPEN11_SH",20,8,1,38,16,22
"ACEPEN12_HF_09","ACEPEN","HF","ACEPEN12_HF",20,8,1,38,24,14
"ACERUB05_SH_12","ACERUB","SH","ACERUB05_SH",20,8,1,50,24,26
"ACERUB06_SH_12","ACERUB","SH","ACERUB06_SH",20,8,1,56,16,40
"ACERUB07_SH_05","ACERUB","SH","ACERUB07_SH",20,8,1,50,16,34
"ACERUB08_SH_10","ACERUB","SH","ACERUB08_SH",20,8,1,24,16,8
"ACERUB09_SH_04","ACERUB","SH","ACERUB09_SH",20,8,1,31,24,7
"ACERUB10_HF_03","ACERUB","HF","ACERUB10_HF",20,8,1,56,50,6
"ACERUB10_SH_12","ACERUB","SH","ACERUB10_SH",20,8,1,31,16,15
"ACERUB11_HF_10","ACERUB","HF","ACERUB11_HF",20,8,1,24,16,8
"ACERUB13_HF_05","ACERUB","HF","ACERUB13_HF",20,8,1,38,16,22
"ACERUB14_HF_02","ACERUB","HF","ACERUB14_HF",20,8,1,50,24,26
"ACERUB99_HF_03","ACERUB","HF","ACERUB99_HF",20,8,1,38,24,14
"ACESAC09_SH_08","ACESAC","SH","ACESAC09_SH",20,8,1,38,31,7
"ACESAC10_SH_12","ACESAC","SH","ACESAC10_SH",20,8,1,38,31,7
"ACESAC99_HF_07","ACESAC","HF","ACESAC99_HF",20,8,1,38,24,14
"ACESAC99_SH_11","ACESAC","SH","ACESAC99_SH",20,8,1,50,38,12
"BETALL01_SH_08","BETALL","SH","BETALL01_SH",20,8,1,50,24,26
"BETALL02_SH_03","BETALL","SH","BETALL02_SH",20,8,1,38,24,14
"BETALL03_SH_01","BETALL","SH","BETALL03_SH",20,8,1,24,16,8
"BETALL08_SH_12","BETALL","SH","BETALL08_SH",20,8,1,24,16,8
"BETALL09_SH_10","BETALL","SH","BETALL09_SH",20,8,1,31,16,15
"BETALL10_HF_07","BETALL","HF","BETALL10_HF",20,8,1,38,24,14
"BETALL10_SH_06","BETALL","SH","BETALL10_SH",20,8,1,24,16,8
"BETALL16_HF_12","BETALL","HF","BETALL16_HF",20,8,1,24,16,8
"BETALL17_HF_09","BETALL","HF","BETALL17_HF",20,8,1,31,24,7
"BETALL18_HF_10","BETALL","HF","BETALL18_HF",20,8,1,31,16,15
"BETALL19_HF_08","BETALL","HF","BETALL19_HF",20,8,1,31,16,15
"BETALL20_HF_08","BETALL","HF","BETALL20_HF",20,8,1,24,16,8
"BETPAP04_SH_11","BETPAP","SH","BETPAP04_SH",20,8,1,24,16,8
"BETPAP06_HF_06","BETPAP","HF","BETPAP06_HF",20,8,1,24,16,8
"BETPAP06_SH_12","BETPAP","SH","BETPAP06_SH",20,8,1,24,16,8
"BETPAP07_SH_07","BETPAP","SH","BETPAP07_SH",20,8,1,50,16,34
"BETPAP08_SH_06","BETPAP","SH","BETPAP08_SH",20,8,1,56,16,40
"BETPAP09_HF_07","BETPAP","HF","BETPAP09_HF",20,8,1,24,16,8
"BETPAP09_SH_12","BETPAP","SH","BETPAP09_SH",20,8,1,24,16,8
"BETPAP10_SH_05","BETPAP","SH","BETPAP10_SH",20,8,1,31,16,15
"BETPAP13_HF_08","BETPAP","HF","BETPAP13_HF",20,8,1,24,16,8
"BETPAP14_HF_04","BETPAP","HF","BETPAP14_HF",20,8,1,24,16,8
"FAGGRA02_SH_05","FAGGRA","SH","FAGGRA02_SH",20,8,1,56,50,6
"FAGGRA10_HF_05","FAGGRA","HF","FAGGRA10_HF",20,8,1,56,50,6
"FAGGRA13_HF_02","FAGGRA","HF","FAGGRA13_HF",20,8,1,56,38,18
"ILEMUC01_SH_12","ILEMUC","SH","ILEMUC01_SH",20,8,1,24,16,8
"ILEMUC03_HF_12","ILEMUC","HF","ILEMUC03_HF",20,8,1,24,16,8
"ILEMUC03_SH_05","ILEMUC","SH","ILEMUC03_SH",20,8,1,31,16,15
"ILEMUC04_HF_12","ILEMUC","HF","ILEMUC04_HF",20,8,1,31,16,15
"ILEMUC04_SH_12","ILEMUC","SH","ILEMUC04_SH",20,8,1,24,16,8
"ILEMUC05_HF_05","ILEMUC","HF","ILEMUC05_HF",20,8,1,24,16,8
"ILEMUC05_SH_07","ILEMUC","SH","ILEMUC05_SH",20,8,1,24,16,8
"ILEMUC06_HF_01","ILEMUC","HF","ILEMUC06_HF",20,8,1,31,24,7
"ILEMUC06_SH_02","ILEMUC","SH","ILEMUC06_SH",20,8,1,24,16,8
"ILEMUC07_HF_09","ILEMUC","HF","ILEMUC07_HF",20,8,1,24,16,8
"ILEMUC07_SH_03","ILEMUC","SH","ILEMUC07_SH",20,8,1,24,16,8
"ILEMUC08_HF_07","ILEMUC","HF","ILEMUC08_HF",20,8,1,24,16,8
"POPGRA01_SH_10","POPGRA","SH","POPGRA01_SH",20,8,1,38,24,14
"POPGRA02_HF_10","POPGRA","HF","POPGRA02_HF",20,8,1,24,16,8
"POPGRA02_SH_02","POPGRA","SH","POPGRA02_SH",20,8,1,31,16,15
"POPGRA03_HF_12","POPGRA","HF","POPGRA03_HF",20,8,1,31,24,7
"POPGRA04_SH_09","POPGRA","SH","POPGRA04_SH",20,8,1,50,38,12
"POPGRA05_HF_09","POPGRA","HF","POPGRA05_HF",20,8,1,50,31,19
"POPGRA05_SH_06","POPGRA","SH","POPGRA05_SH",20,8,1,24,16,8
"POPGRA06_HF_02","POPGRA","HF","POPGRA06_HF",20,8,1,31,24,7
"POPGRA06_SH_05","POPGRA","SH","POPGRA06_SH",20,8,1,31,24,7
"POPGRA07_HF_05","POPGRA","HF","POPGRA07_HF",20,8,1,31,24,7
"POPGRA08_SH_02","POPGRA","SH","POPGRA08_SH",20,8,1,31,16,15
"QUERUB04_SH_05","QUERUB","SH","QUERUB04_SH",20,8,1,31,24,7
"QUERUB05_SH_03","QUERUB","SH","QUERUB05_SH",20,8,1,38,24,14
"QUERUB06_SH_11","QUERUB","SH","QUERUB06_SH",20,8,1,31,24,7
"QUERUB07_SH_09","QUERUB","SH","QUERUB07_SH",20,8,1,31,24,7
"QUERUB08_SH_09","QUERUB","SH","QUERUB08_SH",20,8,1,38,24,14
"QUERUB10_SH_09","QUERUB","SH","QUERUB10_SH",20,8,1,31,24,7
"QUERUB15_HF_06","QUERUB","HF","QUERUB15_HF",20,8,1,31,24,7
"QUERUB16_HF_02","QUERUB","HF","QUERUB16_HF",20,8,1,31,24,7
"QUERUB17_HF_01","QUERUB","HF","QUERUB17_HF",20,8,1,31,24,7
"QUERUB20_HF_12","QUERUB","HF","QUERUB20_HF",20,8,1,31,24,7
"QUERUB23_HF_11","QUERUB","HF","QUERUB23_HF",20,8,1,38,24,14
